Kentrocapros	Aracanidae	Tetraodontiformes	Teleostei
Corcyrogobius	Gobiidae	Gobiiformes	Teleostei
Taeniura	Dasyatidae	Myliobatiformes	Elasmobranchii
Microphilypnus	Eleotridae	Gobiiformes	Teleostei
Ostorhinchus	Apogonidae	Kurtiformes	Teleostei
Aprion	Lutjanidae	Eupercaria/misc	Teleostei
Giuris	Eleotridae	Gobiiformes	Teleostei
Pseudoscaphirhynchus	Acipenseridae	Acipenseriformes	Chondrostei
Canthidermis	Balistidae	Tetraodontiformes	Teleostei
Brachygenys	Haemulidae	Eupercaria/misc	Teleostei
Fonchiiloricaria	Loricariidae	Siluriformes	Teleostei
Omegophora	Tetraodontidae	Tetraodontiformes	Teleostei
Leptorhamdia	Heptapteridae	Siluriformes	Teleostei
Microchirus	Soleidae	Pleuronectiformes	Teleostei
Telmatherina	Telmatherinidae	Atheriniformes	Teleostei
Gygis	Laridae	Charadriiformes	Aves
Centrobranchus	Myctophidae	Myctophiformes	Teleostei
Umbrina	Sciaenidae	Eupercaria/misc	Teleostei
Hypoplectrodes	Anthiadidae	Perciformes/Serranoidei	Teleostei
Grammoplites	Platycephalidae	Perciformes/Scorpaenoidei	Teleostei
Chironemus	Chironemidae	Centrarchiformes	Teleostei
Laiphognathus	Blenniidae	Blenniiformes	Teleostei
Sardinops	Alosidae	Clupeiformes	Teleostei
Triakis	Triakidae	Carcharhiniformes	Elasmobranchii
Pseudotrichonotus	Pseudotrichonotidae	Aulopiformes	Teleostei
Lepidogobius	Gobiidae	Gobiiformes	Teleostei
Channomuraena	Muraenidae	Anguilliformes	Teleostei
Ephippus	Ephippidae	Acanthuriformes	Teleostei
Terapon	Terapontidae	Centrarchiformes	Teleostei
Parachanna	Channidae	Anabantiformes	Teleostei
Ciliata	Gaidropsaridae	Gadiformes	Teleostei
Microlepidotus	Haemulidae	Eupercaria/misc	Teleostei
Soromonichthys	Loricariidae	Siluriformes	Teleostei
Lobotes	Lobotidae	Acanthuriformes	Teleostei
Acreichthys	Monacanthidae	Tetraodontiformes	Teleostei
Saloptia	Epinephelidae	Perciformes/Serranoidei	Teleostei
Lepidorhynchus	Macrouridae	Gadiformes	Teleostei
Hyperprosopon	Embiotocidae	Ovalentaria/misc	Teleostei
Pareiorhina	Loricariidae	Siluriformes	Teleostei
Harpadon	Synodontidae	Aulopiformes	Teleostei
Astronesthes	Stomiidae	Stomiiformes	Teleostei
Erignathus	Phocidae	Carnivora	Mammalia
Aposturisoma	Loricariidae	Siluriformes	Teleostei
Plagiogeneion	Emmelichthyidae	Eupercaria/misc	Teleostei
Morwong	Latridae	Centrarchiformes	Teleostei
Gobiomorphus	Eleotridae	Gobiiformes	Teleostei
Nemichthys	Nemichthyidae	Anguilliformes	Teleostei
Scartella	Blenniidae	Blenniiformes	Teleostei
Phoxinellus	Leuciscidae	Cypriniformes	Teleostei
Mallotus	Osmeridae	Osmeriformes	Teleostei
Serranocirrhitus	Anthiadidae	Perciformes/Serranoidei	Teleostei
Gymnapogon	Apogonidae	Kurtiformes	Teleostei
Cathorops	Ariidae	Siluriformes	Teleostei
Anchoviella	Engraulidae	Clupeiformes	Teleostei
Lissodelphis	Delphinidae	Cetartiodactyla	Mammalia
Semotilus	Leuciscidae	Cypriniformes	Teleostei
Microstomus	Pleuronectidae	Pleuronectiformes	Teleostei
Periophthalmodon	Oxudercidae	Gobiiformes	Teleostei
Ctenotrypauchen	Gobiidae	Gobiiformes	Teleostei
Bathylagichthys	Bathylagidae	Argentiniformes	Teleostei
Gonorynchus	Gonorynchidae	Gonorynchiformes	Teleostei
Centriscus	Centriscidae	Syngnathiformes	Teleostei
Pseudorinelepis	Loricariidae	Siluriformes	Teleostei
Neoceratias	Neoceratiidae	Lophiiformes	Teleostei
Centrodraco	Draconettidae	Callionymiformes	Teleostei
Reinhardtius	Pleuronectidae	Pleuronectiformes	Teleostei
Petrotyx	Bythitidae	Ophidiiformes	Teleostei
Acanthobrama	Leuciscidae	Cypriniformes	Teleostei
Nautichthys	Agonidae	Perciformes/Cottoidei	Teleostei
Serrivomer	Serrivomeridae	Anguilliformes	Teleostei
Axoclinus	Tripterygiidae	Blenniiformes	Teleostei
Rhynchopelates	Terapontidae	Centrarchiformes	Teleostei
Pseudochaenichthys	Channichthyidae	Perciformes/Notothenioidei	Teleostei
Megalancistrus	Loricariidae	Siluriformes	Teleostei
Baryancistrus	Loricariidae	Siluriformes	Teleostei
Thorogobius	Gobiidae	Gobiiformes	Teleostei
Babka	Gobiidae	Gobiiformes	Teleostei
Paralabrax	Serranidae	Perciformes/Serranoidei	Teleostei
Aethaloperca	Epinephelidae	Perciformes/Serranoidei	Teleostei
Chirodactylus	Latridae	Centrarchiformes	Teleostei
Rhadinoloricaria	Loricariidae	Siluriformes	Teleostei
Tilapia	Cichlidae	Cichliformes	Teleostei
Omosudis	Omosudidae	Aulopiformes	Teleostei
Trachinotus	Carangidae	Carangiformes	Teleostei
Peckoltichthys	Loricariidae	Siluriformes	Teleostei
Emmelichthyops	Haemulidae	Eupercaria/misc	Teleostei
Microcarbo	Phalacrocoracidae	Pelecaniformes	Aves
Capoetobrama	Leuciscidae	Cypriniformes	Teleostei
Xiphister	Stichaeidae	Perciformes/Zoarcoidei	Teleostei
Paracanthurus	Acanthuridae	Acanthuriformes	Teleostei
Doboatherina	Atherinidae	Atheriniformes	Teleostei
Ixinandria	Loricariidae	Siluriformes	Teleostei
Lipopterichthys	Loricariidae	Siluriformes	Teleostei
Cantherhines	Monacanthidae	Tetraodontiformes	Teleostei
Fratercula	Alcidae	Charadriiformes	Aves
Paramugil	Mugilidae	Mugiliformes	Teleostei
Lithognathus	Sparidae	Eupercaria/misc	Teleostei
Elagatis	Carangidae	Carangiformes	Teleostei
Carrigobius	Gobiidae	Gobiiformes	Teleostei
Girardinus	Poeciliidae	Cyprinodontiformes	Teleostei
Varicus	Gobiidae	Gobiiformes	Teleostei
Eudyptula	Spheniscidae	Sphenisciformes	Aves
Dexistes	Pleuronectidae	Pleuronectiformes	Teleostei
Ardenna	Procellariidae	Procellariiformes	Aves
Cestraeus	Mugilidae	Mugiliformes	Teleostei
Odontanthias	Anthiadidae	Perciformes/Serranoidei	Teleostei
Congrogadus	Pseudochromidae	Ovalentaria/misc	Teleostei
Charadrius	Charadriidae	Charadriiformes	Aves
Scaevius	Nemipteridae	Eupercaria/misc	Teleostei
Cottocomephorus	Cottidae	Perciformes/Cottoidei	Teleostei
Anisarchus	Lumpenidae	Perciformes/Zoarcoidei	Teleostei
Pararius	Ariidae	Siluriformes	Teleostei
Stellerina	Agonidae	Perciformes/Cottoidei	Teleostei
Scyris	Carangidae	Carangiformes	Teleostei
Lepidorhombus	Scophthalmidae	Pleuronectiformes	Teleostei
Yarrella	Phosichthyidae	Stomiiformes	Teleostei
Gobiosoma	Gobiidae	Gobiiformes	Teleostei
Somateria	Anatidae	Anseriformes	Aves
Histriophoca	Phocidae	Carnivora	Mammalia
Anoplarchus	Stichaeidae	Perciformes/Zoarcoidei	Teleostei
Austroglossus	Soleidae	Pleuronectiformes	Teleostei
Apistogramma	Cichlidae	Cichliformes	Teleostei
Rubricatochromis	Cichlidae	Cichliformes	Teleostei
Dekeyseria	Loricariidae	Siluriformes	Teleostei
Crenimugil	Mugilidae	Mugiliformes	Teleostei
Anchichoerops	Labridae	Eupercaria/misc	Teleostei
Caulolatilus	Latilidae	Eupercaria/misc	Teleostei
Narcinops	Narcinidae	Torpediniformes	Elasmobranchii
Normichthys	Platytroctidae	Alepocephaliformes	Teleostei
Bucephala	Anatidae	Anseriformes	Aves
Cratinus	Serranidae	Perciformes/Serranoidei	Teleostei
Aluterus	Monacanthidae	Tetraodontiformes	Teleostei
Percophis	Percophidae	Perciformes/Percophoidei	Teleostei
Meganthias	Anthiadidae	Perciformes/Serranoidei	Teleostei
Samaris	Samaridae	Pleuronectiformes	Teleostei
Plotosus	Plotosidae	Siluriformes	Teleostei
Eugerres	Gerreidae	Eupercaria/misc	Teleostei
Photoblepharon	Anomalopidae	Trachichthyiformes	Teleostei
Ginsburgellus	Gobiidae	Gobiiformes	Teleostei
Microlepidogaster	Loricariidae	Siluriformes	Teleostei
Derilissus	Gobiesocidae	Gobiesociformes	Teleostei
Sueviota	Gobiidae	Gobiiformes	Teleostei
Chirostoma	Atherinopsidae	Atheriniformes	Teleostei
Oxynotus	Oxynotidae	Squaliformes	Elasmobranchii
Belobranchus	Eleotridae	Gobiiformes	Teleostei
Pterygoplichthys	Loricariidae	Siluriformes	Teleostei
Leptoscarus	Scaridae	Eupercaria/misc	Teleostei
Echidna	Muraenidae	Anguilliformes	Teleostei
Acanthonus	Ophidiidae	Ophidiiformes	Teleostei
Alosa	Alosidae	Clupeiformes	Teleostei
Benthophilus	Gobiidae	Gobiiformes	Teleostei
Rheopresbe	Cottidae	Perciformes	Teleostei
Urophycis	Phycidae	Gadiformes	Teleostei
Glenoglossa	Ophichthidae	Anguilliformes	Teleostei
Pseudomyrophis	Ophichthidae	Anguilliformes	Teleostei
Opsanus	Batrachoididae	Batrachoidiformes	Teleostei
Scombrolabrax	Scombrolabracidae	Scombriformes	Teleostei
Girella	Girellidae	Centrarchiformes	Teleostei
Corythoichthys	Syngnathidae	Syngnathiformes	Teleostei
Pristis	Pristidae	Rhinopristiformes	Elasmobranchii
Dicologlossa	Soleidae	Pleuronectiformes	Teleostei
Doederleinia	Acropomatidae	Acropomatiformes	Teleostei
Taurocottus	Cottidae	Perciformes/Cottoidei	Teleostei
Notorynchus	Hexanchidae	Hexanchiformes	Elasmobranchii
Histiophryne	Histiophrynidae	Lophiiformes	Teleostei
Rhamphochromis	Cichlidae	Cichliformes	Teleostei
Hypseleotris	Eleotridae	Gobiiformes	Teleostei
Brachypterois	Scorpaenidae	Perciformes/Scorpaenoidei	Teleostei
Triaenodon	Carcharhinidae	Carcharhiniformes	Elasmobranchii
Stigmatopora	Syngnathidae	Syngnathiformes	Teleostei
Pandion	Pandionidae	Accipitriformes	Aves
Eleginus	Gadidae	Gadiformes	Teleostei
Limatulichthys	Loricariidae	Siluriformes	Teleostei
Bleekeria	Ammodytidae	Perciformes/Uranoscopoidei	Teleostei
Aldrichetta	Mugilidae	Mugiliformes	Teleostei
Acropoma	Acropomatidae	Acropomatiformes	Teleostei
Gracila	Epinephelidae	Perciformes/Serranoidei	Teleostei
Aruma	Gobiidae	Gobiiformes	Teleostei
Gempylus	Gempylidae	Scombriformes	Teleostei
Turrum	Carangidae	Carangiformes	Teleostei
Zebrus	Gobiidae	Gobiiformes	Teleostei
Dialommus	Labrisomidae	Blenniiformes	Teleostei
Parazen	Parazenidae	Zeiformes	Teleostei
Acanthopagrus	Sparidae	Eupercaria/misc	Teleostei
Hypancistrus	Loricariidae	Siluriformes	Teleostei
Photopectoralis	Leiognathidae	Acanthuriformes	Teleostei
Rhinelepis	Loricariidae	Siluriformes	Teleostei
Lophotibis	Threskiornithidae	Ciconiiformes	Aves
Acanthoclinus	Plesiopidae	Ovalentaria/misc	Teleostei
Stonogobiops	Gobiidae	Gobiiformes	Teleostei
Grammistops	Grammistidae	Perciformes/Serranoidei	Teleostei
Miichthys	Sciaenidae	Eupercaria/misc	Teleostei
Odondebuenia	Gobiidae	Gobiiformes	Teleostei
Hipposcarus	Scaridae	Eupercaria/misc	Teleostei
Chrosomus	Leuciscidae	Cypriniformes	Teleostei
Tigrisoma	Ardeidae	Ciconiiformes	Aves
Quintana	Poeciliidae	Cyprinodontiformes	Teleostei
Telatrygon	Dasyatidae	Myliobatiformes	Elasmobranchii
Quietula	Gobiidae	Gobiiformes	Teleostei
Dacodraco	Channichthyidae	Perciformes/Notothenioidei	Teleostei
Paranotropis	Cyprinidae	Cypriniformes	Teleostei
Centropogon	Tetrarogidae	Perciformes/Scorpaenoidei	Teleostei
Phenacostethus	Phallostethidae	Atheriniformes	Teleostei
Cynoscion	Sciaenidae	Eupercaria/misc	Teleostei
Iotichthys	Leuciscidae	Cypriniformes	Teleostei
Cetorhinus	Cetorhinidae	Lamniformes	Elasmobranchii
Lile	Dorosomatidae	Clupeiformes	Teleostei
Neophron	Accipitridae	Falconiformes	Aves
Myrichthys	Ophichthidae	Anguilliformes	Teleostei
Gammogobius	Gobiidae	Gobiiformes	Teleostei
Parajulis	Labridae	Eupercaria/misc	Teleostei
Nemuroglanis	Heptapteridae	Siluriformes	Teleostei
Ostracion	Ostraciidae	Tetraodontiformes	Teleostei
Barbulifer	Gobiidae	Gobiiformes	Teleostei
Heterostichus	Clinidae	Blenniiformes	Teleostei
Bulbonaricus	Syngnathidae	Syngnathiformes	Teleostei
Bryx	Syngnathidae	Syngnathiformes	Teleostei
Paraplotosus	Plotosidae	Siluriformes	Teleostei
Histrionicus	Anatidae	Anseriformes	Aves
Argyrocottus	Cottidae	Perciformes/Cottoidei	Teleostei
Sciades	Ariidae	Siluriformes	Teleostei
Grammistes	Grammistidae	Perciformes/Serranoidei	Teleostei
Cilus	Sciaenidae	Eupercaria/misc	Teleostei
Basilichthys	Atherinopsidae	Atheriniformes	Teleostei
Cardiopharynx	Cichlidae	Cichliformes	Teleostei
Tomiyamichthys	Gobiidae	Gobiiformes	Teleostei
Amniataba	Terapontidae	Centrarchiformes	Teleostei
Aulopareia	Gobiidae	Gobiiformes	Teleostei
Protanguilla	Protanguillidae	Anguilliformes	Teleostei
Hadropogonichthys	Zoarcidae	Perciformes/Zoarcoidei	Teleostei
Paratriacanthodes	Triacanthodidae	Tetraodontiformes	Teleostei
Argyripnus	Sternoptychidae	Stomiiformes	Teleostei
Cheilinus	Labridae	Eupercaria/misc	Teleostei
Phycis	Phycidae	Gadiformes	Teleostei
Plesiobatis	Plesiobatidae	Myliobatiformes	Elasmobranchii
Benthochromis	Cichlidae	Cichliformes	Teleostei
Lepidopsetta	Pleuronectidae	Pleuronectiformes	Teleostei
Dussumieria	Dussumieriidae	Clupeiformes	Teleostei
Hymenocephalus	Macrouridae	Gadiformes	Teleostei
Cerorhinca	Alcidae	Charadriiformes	Aves
Amblyraja	Rajidae	Rajiformes	Elasmobranchii
Gigantura	Giganturidae	Aulopiformes	Teleostei
Sicydium	Gobiidae	Gobiiformes	Teleostei
Pseudancistrus	Loricariidae	Siluriformes	Teleostei
Katsuwonus	Scombridae	Scombriformes	Teleostei
Brachirus	Soleidae	Pleuronectiformes	Teleostei
Cyema	Cyematidae	Saccopharyngiformes	Teleostei
Himantopus	Recurvirostridae	Charadriiformes	Aves
Cairina	Anatidae	Anseriformes	Aves
Asterorhombus	Bothidae	Pleuronectiformes	Teleostei
Mauligobius	Gobiidae	Gobiiformes	Teleostei
Ancylopsetta	Paralichthyidae	Pleuronectiformes	Teleostei
Archocentrus	Cichlidae	Cichliformes	Teleostei
Glaucostegus	Glaucostegidae	Rhinopristiformes	Elasmobranchii
Starksia	Labrisomidae	Blenniiformes	Teleostei
Microspathodon	Pomacentridae	Ovalentaria/misc	Teleostei
Cromileptes	Epinephelidae	Perciformes	Teleostei
Leptopanchax	Rivulidae	Cyprinodontiformes	Teleostei
Scardinius	Leuciscidae	Cypriniformes	Teleostei
Rhinecanthus	Balistidae	Tetraodontiformes	Teleostei
Leucocarbo	Phalacrocoracidae	Pelecaniformes	Aves
Heliotrygon	Potamotrygonidae	Myliobatiformes	Elasmobranchii
Nexilosus	Pomacentridae	Ovalentaria/misc	Teleostei
Signigobius	Gobiidae	Gobiiformes	Teleostei
Spicomacrurus	Macrouridae	Gadiformes	Teleostei
Pagetodes	Channichthyidae	Perciformes/Notothenioidei	Teleostei
Balistapus	Balistidae	Tetraodontiformes	Teleostei
Panna	Sciaenidae	Eupercaria/misc	Teleostei
Mataeocephalus	Macrouridae	Gadiformes	Teleostei
Eudocimus	Threskiornithidae	Ciconiiformes	Aves
Halichoeres	Labridae	Eupercaria/misc	Teleostei
Dalophis	Ophichthidae	Anguilliformes	Teleostei
Lepidoperca	Anthiadidae	Perciformes/Serranoidei	Teleostei
Caragobius	Gobiidae	Gobiiformes	Teleostei
Achiropsetta	Achiropsettidae	Pleuronectiformes	Teleostei
Apricaphanius	Aphaniidae	Cyprinodontiformes	Teleostei
Paralichthodes	Paralichthodidae	Pleuronectiformes	Teleostei
Tosarhombus	Bothidae	Pleuronectiformes	Teleostei
Blennodon	Tripterygiidae	Blenniiformes	Teleostei
Pseudotylosurus	Belonidae	Beloniformes	Teleostei
Psettodes	Psettodidae	Pleuronectiformes	Teleostei
Orcaella	Delphinidae	Cetartiodactyla	Mammalia
Caesio	Caesionidae	Eupercaria/misc	Teleostei
Sphyrna	Sphyrnidae	Carcharhiniformes	Elasmobranchii
Pogonophryne	Artedidraconidae	Perciformes/Notothenioidei	Teleostei
Rupornis	Accipitridae	Falconiformes	Aves
Typhlogobius	Gobiidae	Gobiiformes	Teleostei
Heterophallus	Poeciliidae	Cyprinodontiformes	Teleostei
Oxyjulis	Labridae	Eupercaria/misc	Teleostei
Coenocorypha	Scolopacidae	Charadriiformes	Aves
Epinephelus	Epinephelidae	Perciformes/Serranoidei	Teleostei
Chauliodus	Stomiidae	Stomiiformes	Teleostei
Cherublemma	Ophidiidae	Ophidiiformes	Teleostei
Pelecus	Leuciscidae	Cypriniformes	Teleostei
Zoarces	Zoarcidae	Perciformes/Zoarcoidei	Teleostei
Rhinichthys	Leuciscidae	Cypriniformes	Teleostei
Chriodorus	Hemiramphidae	Beloniformes	Teleostei
Cryptopsaras	Ceratiidae	Lophiiformes	Teleostei
Austrolebias	Rivulidae	Cyprinodontiformes	Teleostei
Variola	Epinephelidae	Perciformes/Serranoidei	Teleostei
Allenbatrachus	Batrachoididae	Batrachoidiformes	Teleostei
Odontognathus	Pristigasteridae	Clupeiformes	Teleostei
Fontitrygon	Dasyatidae	Myliobatiformes	Elasmobranchii
Dinematichthys	Dinematichthyidae	Ophidiiformes	Teleostei
Plagopterus	Leuciscidae	Cypriniformes	Teleostei
Parascyllium	Parascylliidae	Orectolobiformes	Elasmobranchii
Clupanodon	Dorosomatidae	Clupeiformes	Teleostei
Orbiraja	Rajidae	Rajiformes	Elasmobranchii
Chiloscyllium	Hemiscylliidae	Orectolobiformes	Elasmobranchii
Millerigobius	Gobiidae	Gobiiformes	Teleostei
Agrostichthys	Regalecidae	Lampriformes	Teleostei
Aetobatus	Aetobatidae	Myliobatiformes	Elasmobranchii
Labracoglossa	Scorpididae	Centrarchiformes	Teleostei
Brachyistius	Embiotocidae	Ovalentaria/misc	Teleostei
Petilipinnis	Sciaenidae	Eupercaria/misc	Teleostei
Leporacanthicus	Loricariidae	Siluriformes	Teleostei
Chaenogobius	Gobiidae	Gobiiformes	Teleostei
Macroramphosus	Centriscidae	Syngnathiformes	Teleostei
Coryogalops	Gobiidae	Gobiiformes	Teleostei
Mareca	Anatidae	Anseriformes	Aves
Cirrhigaleus	Squalidae	Squaliformes	Elasmobranchii
Diplecogaster	Gobiesocidae	Gobiesociformes	Teleostei
Notolychnus	Myctophidae	Myctophiformes	Teleostei
Pterodroma	Procellariidae	Procellariiformes	Aves
Myersina	Gobiidae	Gobiiformes	Teleostei
Vanacampus	Syngnathidae	Syngnathiformes	Teleostei
Glaucosoma	Glaucosomatidae	Acropomatiformes	Teleostei
Strongylura	Belonidae	Beloniformes	Teleostei
Pteropsaron	Hemerocoetidae	Acropomatiformes	Teleostei
Anomalochromis	Cichlidae	Cichliformes	Teleostei
Alle	Alcidae	Charadriiformes	Aves
Nandopsis	Cichlidae	Cichliformes	Teleostei
Stalix	Opistognathidae	Ovalentaria/misc	Teleostei
Notoclinus	Tripterygiidae	Blenniiformes	Teleostei
Photostomias	Stomiidae	Stomiiformes	Teleostei
Ryukyupercis	Pinguipedidae	Perciformes/Uranoscopoidei	Teleostei
Pseudotropheus	Cichlidae	Cichliformes	Teleostei
Alepidomus	Atherinidae	Atheriniformes	Teleostei
Simipercis	Pinguipedidae	Perciformes/Uranoscopoidei	Teleostei
Prionurus	Acanthuridae	Acanthuriformes	Teleostei
Lesueurina	Leptoscopidae	Acropomatiformes	Teleostei
Neoraja	Rajidae	Rajiformes	Elasmobranchii
Petroleuciscus	Leuciscidae	Cypriniformes	Teleostei
Vieja	Cichlidae	Cichliformes	Teleostei
Stenobrachius	Myctophidae	Myctophiformes	Teleostei
Paradoxodacna	Ambassidae	Ovalentaria/misc	Teleostei
Iriatherina	Melanotaeniidae	Atheriniformes	Teleostei
Odontaspis	Odontaspididae	Lamniformes	Elasmobranchii
Phaethon	Phaethontidae	Pelecaniformes	Aves
Leptocephalus	Ophichthidae	Anguilliformes	Teleostei
Macronectes	Procellariidae	Procellariiformes	Aves
Gobiodon	Gobiidae	Gobiiformes	Teleostei
Bajacalifornia	Alepocephalidae	Alepocephaliformes	Teleostei
Menidia	Atherinopsidae	Atheriniformes	Teleostei
Zosterisessor	Gobiidae	Gobiiformes	Teleostei
Percalates	Percalatidae	Centrarchiformes	Teleostei
Dentiraja	Rajidae	Rajiformes	Elasmobranchii
Nomorhamphus	Zenarchopteridae	Beloniformes	Teleostei
Thamnaconus	Monacanthidae	Tetraodontiformes	Teleostei
Steindachneria	Steindachneriidae	Gadiformes	Teleostei
Sarpa	Sparidae	Eupercaria/misc	Teleostei
Spilornis	Accipitridae	Falconiformes	Aves
Burhinus	Burhinidae	Charadriiformes	Aves
Alloblennius	Blenniidae	Blenniiformes	Teleostei
Sticharium	Clinidae	Blenniiformes	Teleostei
Photolateralis	Leiognathidae	Acanthuriformes	Teleostei
Opisthopterus	Pristigasteridae	Clupeiformes	Teleostei
Otophidium	Ophidiidae	Ophidiiformes	Teleostei
Vanderhorstia	Gobiidae	Gobiiformes	Teleostei
Psilodraco	Bathydraconidae	Perciformes/Notothenioidei	Teleostei
Notolabrus	Labridae	Eupercaria/misc	Teleostei
Eumecichthys	Lophotidae	Lampriformes	Teleostei
Chaetodipterus	Ephippidae	Acanthuriformes	Teleostei
Poblana	Atherinopsidae	Atheriniformes	Teleostei
Artediellus	Cottidae	Perciformes/Cottoidei	Teleostei
Kopua	Gobiesocidae	Gobiesociformes	Teleostei
Platycaranx	Carangidae	Carangiformes	Teleostei
Neonesthes	Stomiidae	Stomiiformes	Teleostei
Homostolus	Ophidiidae	Ophidiiformes	Teleostei
Salarias	Blenniidae	Blenniiformes	Teleostei
Parachelon	Mugilidae	Mugiliformes	Teleostei
Rondeletia	Rondeletiidae	Beryciformes	Teleostei
Adelotremus	Blenniidae	Blenniiformes	Teleostei
Acipenser	Acipenseridae	Acipenseriformes	Chondrostei
Lethrinops	Cichlidae	Cichliformes	Teleostei
Bathypterois	Ipnopidae	Aulopiformes	Teleostei
Sparisoma	Scaridae	Eupercaria/misc	Teleostei
Haplochromis	Cichlidae	Cichliformes	Teleostei
Chlamydogobius	Gobiidae	Gobiiformes	Teleostei
Hemiglyphidodon	Pomacentridae	Ovalentaria/misc	Teleostei
Pseudotriakis	Pseudotriakidae	Carcharhiniformes	Elasmobranchii
Canthigaster	Tetraodontidae	Tetraodontiformes	Teleostei
Acanthogobius	Gobiidae	Gobiiformes	Teleostei
Pseudolais	Pangasiidae	Siluriformes	Teleostei
Phallocottus	Cottidae	Perciformes/Cottoidei	Teleostei
Tristramella	Cichlidae	Cichliformes	Teleostei
Protochondrostoma	Leuciscidae	Cypriniformes	Teleostei
Koumansetta	Gobiidae	Gobiiformes	Teleostei
Retropinna	Retropinnidae	Osmeriformes	Teleostei
Daysciaena	Sciaenidae	Eupercaria/misc	Teleostei
Kaiwarinus	Carangidae	Carangiformes	Teleostei
Solegnathus	Syngnathidae	Syngnathiformes	Teleostei
Sigmistes	Cottidae	Perciformes/Cottoidei	Teleostei
Gobionotothen	Nototheniidae	Perciformes/Notothenioidei	Teleostei
Otothyropsis	Loricariidae	Siluriformes	Teleostei
Richardsonius	Leuciscidae	Cypriniformes	Teleostei
Melanonus	Melanonidae	Gadiformes	Teleostei
Bregmaceros	Bregmacerotidae	Gadiformes	Teleostei
Cyathopharynx	Cichlidae	Cichliformes	Teleostei
Sphagemacrurus	Macrouridae	Gadiformes	Teleostei
Porichthys	Batrachoididae	Batrachoidiformes	Teleostei
Paracottus	Cottidae	Perciformes/Cottoidei	Teleostei
Lobochilotes	Cichlidae	Cichliformes	Teleostei
Ceratias	Ceratiidae	Lophiiformes	Teleostei
Thalassophryne	Batrachoididae	Batrachoidiformes	Teleostei
Lepidogalaxias	Lepidogalaxiidae	Lepidogalaxiiformes	Teleostei
Elops	Elopidae	Elopiformes	Teleostei
Carlarius	Ariidae	Siluriformes	Teleostei
Sympterygia	Arhynchobatidae	Rajiformes	Elasmobranchii
Laeops	Bothidae	Pleuronectiformes	Teleostei
Pomachromis	Pomacentridae	Ovalentaria/misc	Teleostei
Muraenichthys	Ophichthidae	Anguilliformes	Teleostei
Necrosyrtes	Accipitridae	Falconiformes	Aves
Mene	Menidae	Carangaria/misc	Teleostei
Himantura	Dasyatidae	Myliobatiformes	Elasmobranchii
Mulloidichthys	Mullidae	Mulliformes	Teleostei
Foetorepus	Callionymidae	Callionymiformes	Teleostei
Gymnesigobius	Gobiidae	Gobiiformes	Teleostei
Aequidens	Cichlidae	Cichliformes	Teleostei
Lentipes	Gobiidae	Gobiiformes	Teleostei
Ichthyaetus	Laridae	Charadriiformes	Aves
Halichoerus	Phocidae	Carnivora	Mammalia
Knipowitschia	Gobiidae	Gobiiformes	Teleostei
Mirogrex	Leuciscidae	Cypriniformes	Teleostei
Hydrurga	Phocidae	Carnivora	Mammalia
Kyonemichthys	Syngnathidae	Syngnathiformes	Teleostei
Symphorus	Lutjanidae	Eupercaria/misc	Teleostei
Pseudorca	Delphinidae	Cetartiodactyla	Mammalia
Trinectes	Achiridae	Pleuronectiformes	Teleostei
Oxycercichthys	Pseudochromidae	Ovalentaria/misc	Teleostei
Nematistius	Nematistiidae	Carangiformes	Teleostei
Rhonciscus	Haemulidae	Eupercaria/misc	Teleostei
Kuhlia	Kuhliidae	Centrarchiformes	Teleostei
Planiliza	Mugilidae	Mugiliformes	Teleostei
Culaea	Gasterosteidae	Perciformes/Gasterosteoidei	Teleostei
Bolinichthys	Myctophidae	Myctophiformes	Teleostei
Ogilbia	Dinematichthyidae	Ophidiiformes	Teleostei
Tautoga	Labridae	Eupercaria/misc	Teleostei
Atherinomorus	Atherinidae	Atheriniformes	Teleostei
Chilomycterus	Diodontidae	Tetraodontiformes	Teleostei
Ectreposebastes	Setarchidae	Perciformes/Scorpaenoidei	Teleostei
Xenodexia	Poeciliidae	Cyprinodontiformes	Teleostei
Azurina	Pomacentridae	Ovalentaria/misc	Teleostei
Atlantoraja	Arhynchobatidae	Rajiformes	Elasmobranchii
Zameus	Somniosidae	Squaliformes	Elasmobranchii
Coryphopterus	Gobiidae	Gobiiformes	Teleostei
Neosynchiropus	Callionymidae	Callionymiformes	Teleostei
Retroculus	Cichlidae	Cichliformes	Teleostei
Tomocichla	Cichlidae	Cichliformes	Teleostei
Mccoskerichthys	Chaenopsidae	Blenniiformes	Teleostei
Anoplocapros	Aracanidae	Tetraodontiformes	Teleostei
Ophisternon	Synbranchidae	Synbranchiformes	Teleostei
Masturus	Molidae	Tetraodontiformes	Teleostei
Percis	Agonidae	Perciformes/Cottoidei	Teleostei
Pagodroma	Procellariidae	Procellariiformes	Aves
Helicolenus	Sebastidae	Perciformes/Scorpaenoidei	Teleostei
Labropsis	Labridae	Eupercaria/misc	Teleostei
Callionymus	Callionymidae	Callionymiformes	Teleostei
Brochiloricaria	Loricariidae	Siluriformes	Teleostei
Tetractenos	Tetraodontidae	Tetraodontiformes	Teleostei
Hypoptopoma	Loricariidae	Siluriformes	Teleostei
Ekemblemaria	Chaenopsidae	Blenniiformes	Teleostei
Larimichthys	Sciaenidae	Eupercaria/misc	Teleostei
Cheimerius	Sparidae	Eupercaria/misc	Teleostei
Allothunnus	Scombridae	Scombriformes	Teleostei
Bertella	Oneirodidae	Lophiiformes	Teleostei
Pelmatochromis	Cichlidae	Cichliformes	Teleostei
Cirrhitichthys	Cirrhitidae	Centrarchiformes	Teleostei
Cirrhoscyllium	Parascylliidae	Orectolobiformes	Elasmobranchii
Scorpaenopsis	Scorpaenidae	Perciformes/Scorpaenoidei	Teleostei
Richardsonichthys	Tetrarogidae	Perciformes/Scorpaenoidei	Teleostei
Sula	Sulidae	Pelecaniformes	Aves
Oidiphorus	Zoarcidae	Perciformes/Zoarcoidei	Teleostei
Pseudojuloides	Labridae	Eupercaria/misc	Teleostei
Cephalurus	Pentanchidae	Carcharhiniformes	Elasmobranchii
Histrio	Antennariidae	Lophiiformes	Teleostei
Dysalotus	Chiasmodontidae	Scombriformes	Teleostei
Notesthes	Tetrarogidae	Perciformes/Scorpaenoidei	Teleostei
Eugnathogobius	Gobiidae	Gobiiformes	Teleostei
Gastrocyathus	Gobiesocidae	Gobiesociformes	Teleostei
Parastromateus	Carangidae	Carangiformes	Teleostei
Neofundulus	Rivulidae	Cyprinodontiformes	Teleostei
Enchelyurus	Blenniidae	Blenniiformes	Teleostei
Laimosemion	Rivulidae	Cyprinodontiformes	Teleostei
Pholis	Pholidae	Perciformes/Zoarcoidei	Teleostei
Pholidichthys	Pholidichthyidae	Cichliformes	Teleostei
Hippoglossus	Pleuronectidae	Pleuronectiformes	Teleostei
Ophioscion	Sciaenidae	Eupercaria/misc	Teleostei
Hypostomus	Loricariidae	Siluriformes	Teleostei
Pollachius	Gadidae	Gadiformes	Teleostei
Triacanthus	Triacanthidae	Tetraodontiformes	Teleostei
Apeltes	Gasterosteidae	Perciformes/Gasterosteoidei	Teleostei
Brachygalaxias	Galaxiidae	Galaxiiformes	Teleostei
Diagramma	Haemulidae	Eupercaria/misc	Teleostei
Adelosebastes	Sebastidae	Perciformes/Scorpaenoidei	Teleostei
Tateurndina	Eleotridae	Gobiiformes	Teleostei
Atrobucca	Sciaenidae	Eupercaria/misc	Teleostei
Scleropages	Osteoglossidae	Osteoglossiformes	Teleostei
Callechelys	Ophichthidae	Anguilliformes	Teleostei
Synapturichthys	Soleidae	Pleuronectiformes	Teleostei
Aphanopus	Trichiuridae	Scombriformes	Teleostei
Natalichthys	Pseudochromidae	Ovalentaria/misc	Teleostei
Jaydia	Apogonidae	Kurtiformes	Teleostei
Grammatobothus	Bothidae	Pleuronectiformes	Teleostei
Neblinichthys	Loricariidae	Siluriformes	Teleostei
Marilyna	Tetraodontidae	Tetraodontiformes	Teleostei
Scomberomorus	Scombridae	Scombriformes	Teleostei
Pleuroscopus	Uranoscopidae	Perciformes/Uranoscopoidei	Teleostei
Aurigequula	Leiognathidae	Acanthuriformes	Teleostei
Anchoa	Engraulidae	Clupeiformes	Teleostei
Mendosoma	Latridae	Centrarchiformes	Teleostei
Ruvettus	Gempylidae	Scombriformes	Teleostei
Calotomus	Scaridae	Eupercaria/misc	Teleostei
Phyllophryne	Histiophrynidae	Lophiiformes	Teleostei
Hypomesus	Osmeridae	Osmeriformes	Teleostei
Halaelurus	Pentanchidae	Carcharhiniformes	Elasmobranchii
Lythrypnus	Gobiidae	Gobiiformes	Teleostei
Leiocottus	Cottidae	Perciformes/Cottoidei	Teleostei
Hemigaleus	Hemigaleidae	Carcharhiniformes	Elasmobranchii
Repomucenus	Callionymidae	Callionymiformes	Teleostei
Amphiarius	Ariidae	Siluriformes	Teleostei
Aulichthys	Hypoptychidae	Perciformes/Gasterosteoidei	Teleostei
Macrosmia	Macrouridae	Gadiformes	Teleostei
Etia	Cichlidae	Cichliformes	Teleostei
Mesopristes	Terapontidae	Centrarchiformes	Teleostei
Parma	Pomacentridae	Ovalentaria/misc	Teleostei
Pseudapocryptes	Oxudercidae	Gobiiformes	Teleostei
Thalassoma	Labridae	Eupercaria/misc	Teleostei
Coradion	Chaetodontidae	Acanthuriformes	Teleostei
Pellona	Pristigasteridae	Clupeiformes	Teleostei
Halobatrachus	Batrachoididae	Batrachoidiformes	Teleostei
Pagetopsis	Channichthyidae	Perciformes/Notothenioidei	Teleostei
Ilyophis	Synaphobranchidae	Anguilliformes	Teleostei
Neolamprologus	Cichlidae	Cichliformes	Teleostei
Taeniurops	Dasyatidae	Myliobatiformes	Elasmobranchii
Tetragonurus	Tetragonuridae	Scombriformes	Teleostei
Ereunias	Rhamphocottidae	Perciformes/Cottoidei	Teleostei
Leucophaeus	Laridae	Charadriiformes	Aves
Pseudobalistes	Balistidae	Tetraodontiformes	Teleostei
Anablepsoides	Rivulidae	Cyprinodontiformes	Teleostei
Seriphus	Sciaenidae	Eupercaria/misc	Teleostei
Nemanthias	Anthiadidae	Perciformes/Serranoidei	Teleostei
Diploprion	Liopropomatidae	Perciformes/Serranoidei	Teleostei
Deltentosteus	Gobiidae	Gobiiformes	Teleostei
Aechmophorus	Podicipedidae	Podicipediformes	Aves
Megalonibea	Sciaenidae	Eupercaria/misc	Teleostei
Centrophryne	Centrophrynidae	Lophiiformes	Teleostei
Planiloricaria	Loricariidae	Siluriformes	Teleostei
Onychoprion	Laridae	Charadriiformes	Aves
Hollardia	Triacanthodidae	Tetraodontiformes	Teleostei
Oxylapia	Cichlidae	Cichliformes	Teleostei
Stigmatogobius	Gobiidae	Gobiiformes	Teleostei
Crossoloricaria	Loricariidae	Siluriformes	Teleostei
Cygnus	Anatidae	Anseriformes	Aves
Berardius	Ziphiidae	Cetartiodactyla	Mammalia
Coregonus	Salmonidae	Salmoniformes	Teleostei
Paralonchurus	Sciaenidae	Eupercaria/misc	Teleostei
Tarletonbeania	Myctophidae	Myctophiformes	Teleostei
Phytichthys	Stichaeidae	Perciformes/Zoarcoidei	Teleostei
Guttigadus	Moridae	Gadiformes	Teleostei
Taeniacara	Cichlidae	Cichliformes	Teleostei
Haplophryne	Linophrynidae	Lophiiformes	Teleostei
Asymbolus	Pentanchidae	Carcharhiniformes	Elasmobranchii
Holanthias	Anthiadidae	Perciformes/Serranoidei	Teleostei
Pegusa	Soleidae	Pleuronectiformes	Teleostei
Ehirava	Ehiravidae	Clupeiformes	Teleostei
Nemateleotris	Microdesmidae	Gobiiformes	Teleostei
Jordanella	Cyprinodontidae	Cyprinodontiformes	Teleostei
Novaculichthys	Labridae	Eupercaria/misc	Teleostei
Rhinomugil	Mugilidae	Mugiliformes	Teleostei
Coralliozetus	Chaenopsidae	Blenniiformes	Teleostei
Nesogobius	Gobiidae	Gobiiformes	Teleostei
Promethichthys	Gempylidae	Scombriformes	Teleostei
Scobinichthys	Monacanthidae	Tetraodontiformes	Teleostei
Aristostomias	Stomiidae	Stomiiformes	Teleostei
Trachidermus	Cottidae	Perciformes/Cottoidei	Teleostei
Searsia	Platytroctidae	Alepocephaliformes	Teleostei
Paramonacanthus	Monacanthidae	Tetraodontiformes	Teleostei
Stichaeus	Stichaeidae	Perciformes/Zoarcoidei	Teleostei
Odontopyxis	Agonidae	Perciformes/Cottoidei	Teleostei
Phocoenoides	Phocoenidae	Cetartiodactyla	Mammalia
Parapriacanthus	Pempheridae	Acropomatiformes	Teleostei
Nycticorax	Ardeidae	Ciconiiformes	Aves
Lepidoblepharon	Citharidae	Pleuronectiformes	Teleostei
Prognathodes	Chaetodontidae	Acanthuriformes	Teleostei
Gymnocrotaphus	Sparidae	Eupercaria/misc	Teleostei
Mugil	Mugilidae	Mugiliformes	Teleostei
Spinachia	Gasterosteidae	Perciformes/Gasterosteoidei	Teleostei
Bairdiella	Sciaenidae	Eupercaria/misc	Teleostei
Paracirrhites	Cirrhitidae	Centrarchiformes	Teleostei
Apistogrammoides	Cichlidae	Cichliformes	Teleostei
Mazarunia	Cichlidae	Cichliformes	Teleostei
Parananochromis	Cichlidae	Cichliformes	Teleostei
Circaetus	Accipitridae	Falconiformes	Aves
Anous	Laridae	Charadriiformes	Aves
Lampanyctus	Myctophidae	Myctophiformes	Teleostei
Atelomycterus	Atelomycteridae	Carcharhiniformes	Elasmobranchii
Parachromis	Cichlidae	Cichliformes	Teleostei
Ancistrogobius	Gobiidae	Gobiiformes	Teleostei
Cynoponticus	Muraenesocidae	Anguilliformes	Teleostei
Chetia	Cichlidae	Cichliformes	Teleostei
Pseudocyttus	Oreosomatidae	Zeiformes	Teleostei
Cynomacrurus	Macrouridae	Gadiformes	Teleostei
Astrocottus	Cottidae	Perciformes/Cottoidei	Teleostei
Hyperoglyphe	Centrolophidae	Scombriformes	Teleostei
Dasyscopelus	Myctophidae	Myctophiformes	Teleostei
Patagonotothen	Nototheniidae	Perciformes/Notothenioidei	Teleostei
Antennablennius	Blenniidae	Blenniiformes	Teleostei
Virididentex	Sparidae	Eupercaria/misc	Teleostei
Chaenocephalus	Channichthyidae	Perciformes/Notothenioidei	Teleostei
Nannacara	Cichlidae	Cichliformes	Teleostei
Leucos	Leuciscidae	Cypriniformes	Teleostei
Syngnathus	Syngnathidae	Syngnathiformes	Teleostei
Capros	Caproidae	Acanthuriformes	Teleostei
Gudusia	Dorosomatidae	Clupeiformes	Teleostei
Semicossyphus	Labridae	Eupercaria/misc	Teleostei
Hysterocarpus	Embiotocidae	Ovalentaria/misc	Teleostei
Peckoltia	Loricariidae	Siluriformes	Teleostei
Sanopus	Batrachoididae	Batrachoidiformes	Teleostei
Leptocharias	Leptochariidae	Carcharhiniformes	Elasmobranchii
Iago	Triakidae	Carcharhiniformes	Elasmobranchii
Pluvianellus	Pluvianellidae	Charadriiformes	Aves
Rutilus	Leuciscidae	Cypriniformes	Teleostei
Chelon	Mugilidae	Mugiliformes	Teleostei
Myxodes	Clinidae	Blenniiformes	Teleostei
Jenkinsia	Spratelloididae	Clupeiformes	Teleostei
Rhincodon	Rhincodontidae	Orectolobiformes	Elasmobranchii
Acanthocepola	Cepolidae	Eupercaria/misc	Teleostei
Bathylaco	Alepocephalidae	Alepocephaliformes	Teleostei
Psephurus	Polyodontidae	Acipenseriformes	Chondrostei
Shuja	Cichlidae	Cichliformes	Teleostei
Spathodus	Cichlidae	Cichliformes	Teleostei
Ipnops	Ipnopidae	Aulopiformes	Teleostei
Hemirhamphodon	Zenarchopteridae	Beloniformes	Teleostei
Lophiomus	Lophiidae	Lophiiformes	Teleostei
Chilotilapia	Cichlidae	Cichliformes	Teleostei
Triglops	Cottidae	Perciformes/Cottoidei	Teleostei
Arapaima	Arapaimidae	Osteoglossiformes	Teleostei
Delminichthys	Leuciscidae	Cypriniformes	Teleostei
Brevitrygon	Dasyatidae	Myliobatiformes	Elasmobranchii
Akko	Gobiidae	Gobiiformes	Teleostei
Neocaristius	Caristiidae	Scombriformes	Teleostei
Benitochromis	Cichlidae	Cichliformes	Teleostei
Selene	Carangidae	Carangiformes	Teleostei
Arctogadus	Gadidae	Gadiformes	Teleostei
Carcharhinus	Carcharhinidae	Carcharhiniformes	Elasmobranchii
Oreosoma	Oreosomatidae	Zeiformes	Teleostei
Monachus	Phocidae	Carnivora	Mammalia
Springeratus	Clinidae	Blenniiformes	Teleostei
Lepidocybium	Gempylidae	Scombriformes	Teleostei
Cirripectes	Blenniidae	Blenniiformes	Teleostei
Lucayablennius	Chaenopsidae	Blenniiformes	Teleostei
Phoebetria	Diomedeidae	Procellariiformes	Aves
Stylephorus	Stylephoridae	Stylephoriformes	Teleostei
Icelinus	Cottidae	Perciformes/Cottoidei	Teleostei
Enchelyopus	Gaidropsaridae	Gadiformes	Teleostei
Polydactylus	Polynemidae	Carangaria/misc	Teleostei
Sousa	Delphinidae	Cetartiodactyla	Mammalia
Danacetichthys	Cetomimidae	Beryciformes	Teleostei
Clupeoides	Ehiravidae	Clupeiformes	Teleostei
Notograptus	Plesiopidae	Ovalentaria/misc	Teleostei
Polypera	Liparidae	Perciformes/Cottoidei	Teleostei
Sebastolobus	Sebastidae	Perciformes/Scorpaenoidei	Teleostei
Sauvagella	Ehiravidae	Clupeiformes	Teleostei
Aspistor	Ariidae	Siluriformes	Teleostei
Pisodonophis	Ophichthidae	Anguilliformes	Teleostei
Arothron	Tetraodontidae	Tetraodontiformes	Teleostei
Rhynchorhamphus	Hemiramphidae	Beloniformes	Teleostei
Clinostomus	Leuciscidae	Cypriniformes	Teleostei
Malthopsis	Ogcocephalidae	Lophiiformes	Teleostei
Calonectris	Procellariidae	Procellariiformes	Aves
Bothrocara	Zoarcidae	Perciformes/Zoarcoidei	Teleostei
Anoplopoma	Anoplopomatidae	Perciformes/Cottoidei	Teleostei
Lophonectes	Bothidae	Pleuronectiformes	Teleostei
Acanthochromis	Pomacentridae	Ovalentaria/misc	Teleostei
Cynopoecilus	Rivulidae	Cyprinodontiformes	Teleostei
Pseudogramma	Grammistidae	Perciformes/Serranoidei	Teleostei
Dugong	Dugongidae	Sirenia	Mammalia
Isacia	Haemulidae	Eupercaria/misc	Teleostei
Comephorus	Cottidae	Perciformes/Cottoidei	Teleostei
Moringua	Moringuidae	Anguilliformes	Teleostei
Eubalaena	Balaenidae	Cetartiodactyla	Mammalia
Cercamia	Apogonidae	Kurtiformes	Teleostei
Zapteryx	Trygonorrhinidae	Rhinopristiformes	Elasmobranchii
Potamotrygon	Potamotrygonidae	Myliobatiformes	Elasmobranchii
Myxus	Mugilidae	Mugiliformes	Teleostei
Oreoleuciscus	Leuciscidae	Cypriniformes	Teleostei
Buglossidium	Soleidae	Pleuronectiformes	Teleostei
Maratecoara	Rivulidae	Cyprinodontiformes	Teleostei
Lactarius	Lactariidae	Carangaria/misc	Teleostei
Konia	Cichlidae	Cichliformes	Teleostei
Mola	Molidae	Tetraodontiformes	Teleostei
Harttia	Loricariidae	Siluriformes	Teleostei
Hoplopagrus	Lutjanidae	Eupercaria/misc	Teleostei
Xenichthys	Haemulidae	Eupercaria/misc	Teleostei
Barbourisia	Barbourisiidae	Beryciformes	Teleostei
Trachicephalus	Synanceiidae	Perciformes/Scorpaenoidei	Teleostei
Echeneis	Echeneidae	Carangiformes	Teleostei
Scopelarchoides	Scopelarchidae	Aulopiformes	Teleostei
Aphaniops	Aphaniidae	Cyprinodontiformes	Teleostei
Pelecanoides	Pelecanoididae	Procellariiformes	Aves
Cribroheros	Cichlidae	Cichliformes	Teleostei
Leptostichaeus	Eulophiidae	Perciformes/Zoarcoidei	Teleostei
Acestridium	Loricariidae	Siluriformes	Teleostei
Normanichthys	Normanichthyidae	Perciformes/Scorpaenoidei	Teleostei
Melanostigma	Zoarcidae	Perciformes/Zoarcoidei	Teleostei
Cyprinocirrhites	Cirrhitidae	Centrarchiformes	Teleostei
Orthodon	Leuciscidae	Cypriniformes	Teleostei
Leiostomus	Sciaenidae	Eupercaria/misc	Teleostei
Leptacanthichthys	Oneirodidae	Lophiiformes	Teleostei
Brachydeuterus	Haemulidae	Eupercaria/misc	Teleostei
Proeumicrotremus	Cyclopteridae	Perciformes/Cottoidei	Teleostei
Cymatogaster	Embiotocidae	Ovalentaria/misc	Teleostei
Pteroidichthys	Scorpaenidae	Perciformes/Scorpaenoidei	Teleostei
Oreochromis	Cichlidae	Cichliformes	Teleostei
Pingalla	Terapontidae	Centrarchiformes	Teleostei
Centrophorus	Centrophoridae	Squaliformes	Elasmobranchii
Heros	Cichlidae	Cichliformes	Teleostei
Temnocora	Liparidae	Perciformes/Cottoidei	Teleostei
Diplacanthopoma	Bythitidae	Ophidiiformes	Teleostei
Zalieutes	Ogcocephalidae	Lophiiformes	Teleostei
Gymnelopsis	Zoarcidae	Perciformes/Zoarcoidei	Teleostei
Gazza	Leiognathidae	Acanthuriformes	Teleostei
Stolothrissa	Dorosomatidae	Clupeiformes	Teleostei
Dasyatis	Dasyatidae	Myliobatiformes	Elasmobranchii
Pleuronichthys	Pleuronectidae	Pleuronectiformes	Teleostei
Otothyris	Loricariidae	Siluriformes	Teleostei
Neopomacentrus	Pomacentridae	Ovalentaria/misc	Teleostei
Bembradium	Bembridae	Perciformes/Scorpaenoidei	Teleostei
Belonoperca	Liopropomatidae	Perciformes/Serranoidei	Teleostei
Netta	Anatidae	Anseriformes	Aves
Kochichthys	Pinguipedidae	Perciformes/Uranoscopoidei	Teleostei
Chlamydoselachus	Chlamydoselachidae	Hexanchiformes	Elasmobranchii
Phalloceros	Poeciliidae	Cyprinodontiformes	Teleostei
Trigonognathus	Etmopteridae	Squaliformes	Elasmobranchii
Lycozoarces	Zoarcidae	Perciformes/Zoarcoidei	Teleostei
Konosirus	Dorosomatidae	Clupeiformes	Teleostei
Steno	Delphinidae	Cetartiodactyla	Mammalia
Hybognathus	Leuciscidae	Cypriniformes	Teleostei
Eucrossorhinus	Orectolobidae	Orectolobiformes	Elasmobranchii
Nerophis	Syngnathidae	Syngnathiformes	Teleostei
Dajaus	Mugilidae	Mugiliformes	Teleostei
Amsichthys	Pseudochromidae	Ovalentaria/misc	Teleostei
Odontostomias	Stomiidae	Stomiiformes	Teleostei
Couesius	Leuciscidae	Cypriniformes	Teleostei
Liopropoma	Liopropomatidae	Perciformes/Serranoidei	Teleostei
Plectobranchus	Opisthocentridae	Perciformes/Zoarcoidei	Teleostei
Enophrys	Cottidae	Perciformes/Cottoidei	Teleostei
Sillaginopsis	Sillaginidae	Eupercaria/misc	Teleostei
Askoldia	Opisthocentridae	Perciformes/Zoarcoidei	Teleostei
Bubulcus	Ardeidae	Ciconiiformes	Aves
Pelagodroma	Hydrobatidae	Procellariiformes	Aves
Hippocampus	Syngnathidae	Syngnathiformes	Teleostei
Pseudodax	Labridae	Eupercaria/misc	Teleostei
Grammatorcynus	Scombridae	Scombriformes	Teleostei
Goeldiella	Heptapteridae	Siluriformes	Teleostei
Pimephales	Leuciscidae	Cypriniformes	Teleostei
Pseudogobius	Gobiidae	Gobiiformes	Teleostei
Alectis	Carangidae	Carangiformes	Teleostei
Pseudoqolus	Loricariidae	Siluriformes	Teleostei
Puck	Oneirodidae	Lophiiformes	Teleostei
Melanocetus	Melanocetidae	Lophiiformes	Teleostei
Loricariichthys	Loricariidae	Siluriformes	Teleostei
Plesiolebias	Rivulidae	Cyprinodontiformes	Teleostei
Catathyridium	Achiridae	Pleuronectiformes	Teleostei
Cheilodipterus	Apogonidae	Kurtiformes	Teleostei
Talismania	Alepocephalidae	Alepocephaliformes	Teleostei
Cottapistus	Tetrarogidae	Perciformes/Scorpaenoidei	Teleostei
Bhanotia	Syngnathidae	Syngnathiformes	Teleostei
Spectracanthicus	Loricariidae	Siluriformes	Teleostei
Chorisochismus	Gobiesocidae	Gobiesociformes	Teleostei
Ablennes	Belonidae	Beloniformes	Teleostei
Cryptarius	Ariidae	Siluriformes	Teleostei
Grammicolepis	Grammicolepididae	Zeiformes	Teleostei
Synaphobranchus	Synaphobranchidae	Anguilliformes	Teleostei
Leucoraja	Rajidae	Rajiformes	Elasmobranchii
Creagrus	Laridae	Charadriiformes	Aves
Trachurus	Carangidae	Carangiformes	Teleostei
Ilisha	Pristigasteridae	Clupeiformes	Teleostei
Cetengraulis	Engraulidae	Clupeiformes	Teleostei
Balistoides	Balistidae	Tetraodontiformes	Teleostei
Chelonodontops	Tetraodontidae	Tetraodontiformes	Teleostei
Pateobatis	Dasyatidae	Myliobatiformes	Elasmobranchii
Scobinancistrus	Loricariidae	Siluriformes	Teleostei
Matsubaraea	Hemerocoetidae	Acropomatiformes	Teleostei
Macrhybopsis	Leuciscidae	Cypriniformes	Teleostei
Rynchops	Rynchopidae	Charadriiformes	Aves
Nemapteryx	Ariidae	Siluriformes	Teleostei
Corica	Ehiravidae	Clupeiformes	Teleostei
Ctenochromis	Cichlidae	Cichliformes	Teleostei
Conidens	Gobiesocidae	Gobiesociformes	Teleostei
Hoplias	Erythrinidae	Characiformes	Teleostei
Trypauchen	Gobiidae	Gobiiformes	Teleostei
Rostrhamus	Accipitridae	Falconiformes	Aves
Globicephala	Delphinidae	Cetartiodactyla	Mammalia
Lagenorhynchus	Delphinidae	Cetartiodactyla	Mammalia
Eurymen	Psychrolutidae	Perciformes/Cottoidei	Teleostei
Clinitrachus	Clinidae	Blenniiformes	Teleostei
Pollichthys	Phosichthyidae	Stomiiformes	Teleostei
Photonectes	Stomiidae	Stomiiformes	Teleostei
Hemerocoetes	Hemerocoetidae	Acropomatiformes	Teleostei
Macropinna	Opisthoproctidae	Argentiniformes	Teleostei
Lestidium	Lestidiidae	Aulopiformes	Teleostei
Glareola	Glareolidae	Charadriiformes	Aves
Jenynsia	Anablepidae	Cyprinodontiformes	Teleostei
Pleurosicya	Gobiidae	Gobiiformes	Teleostei
Rhinochimaera	Rhinochimaeridae	Chimaeriformes	Holocephali
Branta	Anatidae	Anseriformes	Aves
Trigonolampa	Stomiidae	Stomiiformes	Teleostei
Norfolkia	Tripterygiidae	Blenniiformes	Teleostei
Synchirus	Cottidae	Perciformes/Cottoidei	Teleostei
Roncador	Sciaenidae	Eupercaria/misc	Teleostei
Pseudopleuronectes	Pleuronectidae	Pleuronectiformes	Teleostei
Rinoctes	Alepocephalidae	Alepocephaliformes	Teleostei
Paloa	Butidae	Gobiiformes	Teleostei
Muraenesox	Muraenesocidae	Anguilliformes	Teleostei
Aptocyclus	Cyclopteridae	Perciformes/Cottoidei	Teleostei
Bryaninops	Gobiidae	Gobiiformes	Teleostei
Eustomias	Stomiidae	Stomiiformes	Teleostei
Danakilia	Cichlidae	Cichliformes	Teleostei
Lophonetta	Anatidae	Anseriformes	Aves
Ophiogobius	Gobiidae	Gobiiformes	Teleostei
Hippichthys	Syngnathidae	Syngnathiformes	Teleostei
Mikrogeophagus	Cichlidae	Cichliformes	Teleostei
Novaculops	Labridae	Eupercaria/misc	Teleostei
Phenacoscorpius	Scorpaenidae	Perciformes/Scorpaenoidei	Teleostei
Liparis	Liparidae	Perciformes/Cottoidei	Teleostei
Galeocerdo	Galeocerdonidae	Carcharhiniformes	Elasmobranchii
Wallaceochromis	Cichlidae	Cichliformes	Teleostei
Tripterygion	Tripterygiidae	Blenniiformes	Teleostei
Grampus	Delphinidae	Cetartiodactyla	Mammalia
Melanogrammus	Gadidae	Gadiformes	Teleostei
Porcostoma	Sparidae	Eupercaria/misc	Teleostei
Draculo	Callionymidae	Callionymiformes	Teleostei
Tominanga	Telmatherinidae	Atheriniformes	Teleostei
Lophiogobius	Gobiidae	Gobiiformes	Teleostei
Brachyrhaphis	Poeciliidae	Cyprinodontiformes	Teleostei
Sibirionetta	Anatidae	Anseriformes	Aves
Pituna	Rivulidae	Cyprinodontiformes	Teleostei
Trachyscorpia	Sebastidae	Perciformes/Scorpaenoidei	Teleostei
Thalassarche	Diomedeidae	Procellariiformes	Aves
Baldwinella	Anthiadidae	Perciformes/Serranoidei	Teleostei
Cyathochromis	Cichlidae	Cichliformes	Teleostei
Urolophus	Urolophidae	Myliobatiformes	Elasmobranchii
Coryphoblennius	Blenniidae	Blenniiformes	Teleostei
Caesioperca	Anthiadidae	Perciformes/Serranoidei	Teleostei
Rivulus	Rivulidae	Cyprinodontiformes	Teleostei
Aspasma	Gobiesocidae	Gobiesociformes	Teleostei
Scolecenchelys	Ophichthidae	Anguilliformes	Teleostei
Pareques	Sciaenidae	Eupercaria/misc	Teleostei
Cephaloscyllium	Scyliorhinidae	Carcharhiniformes	Elasmobranchii
Brachygobius	Gobiidae	Gobiiformes	Teleostei
Cottunculus	Psychrolutidae	Perciformes/Cottoidei	Teleostei
Nematolebias	Rivulidae	Cyprinodontiformes	Teleostei
Cursorius	Glareolidae	Charadriiformes	Aves
Pseudocoris	Labridae	Eupercaria/misc	Teleostei
Paratherina	Telmatherinidae	Atheriniformes	Teleostei
Agosia	Leuciscidae	Cypriniformes	Teleostei
Microphis	Syngnathidae	Syngnathiformes	Teleostei
Ozichthys	Apogonidae	Kurtiformes	Teleostei
Chortiheros	Cichlidae	Cichliformes	Teleostei
Parascorpaena	Scorpaenidae	Perciformes/Scorpaenoidei	Teleostei
Upeneichthys	Mullidae	Mulliformes	Teleostei
Parachaenichthys	Bathydraconidae	Perciformes/Notothenioidei	Teleostei
Symphodus	Labridae	Eupercaria/misc	Teleostei
Chelidoperca	Serranidae	Perciformes/Serranoidei	Teleostei
Latris	Latridae	Centrarchiformes	Teleostei
Luciogobius	Gobiidae	Gobiiformes	Teleostei
Gasterosteus	Gasterosteidae	Perciformes/Gasterosteoidei	Teleostei
Trachystoma	Mugilidae	Mugiliformes	Teleostei
Lebetus	Gobiidae	Gobiiformes	Teleostei
Hemipristis	Hemigaleidae	Carcharhiniformes	Elasmobranchii
Macropharyngodon	Labridae	Eupercaria/misc	Teleostei
Sunagocia	Platycephalidae	Perciformes/Scorpaenoidei	Teleostei
Dischistodus	Pomacentridae	Ovalentaria/misc	Teleostei
Artedius	Cottidae	Perciformes/Cottoidei	Teleostei
Parasudis	Chlorophthalmidae	Aulopiformes	Teleostei
Mergellus	Anatidae	Anseriformes	Aves
Aesopia	Soleidae	Pleuronectiformes	Teleostei
Cichla	Cichlidae	Cichliformes	Teleostei
Bathysolea	Soleidae	Pleuronectiformes	Teleostei
Gladiogobius	Gobiidae	Gobiiformes	Teleostei
Kumba	Macrouridae	Gadiformes	Teleostei
Nes	Gobiidae	Gobiiformes	Teleostei
Notropis	Leuciscidae	Cypriniformes	Teleostei
Gastropsetta	Paralichthyidae	Pleuronectiformes	Teleostei
Muraenoclinus	Clinidae	Blenniiformes	Teleostei
Mahidolia	Gobiidae	Gobiiformes	Teleostei
Huso	Acipenseridae	Acipenseriformes	Chondrostei
Aptychotrema	Trygonorrhinidae	Rhinopristiformes	Elasmobranchii
Chaetodon	Chaetodontidae	Acanthuriformes	Teleostei
Ogcocephalus	Ogcocephalidae	Lophiiformes	Teleostei
Hypsypops	Pomacentridae	Ovalentaria/misc	Teleostei
Belone	Belonidae	Beloniformes	Teleostei
Ophidion	Ophidiidae	Ophidiiformes	Teleostei
Rhamdiopsis	Heptapteridae	Siluriformes	Teleostei
Micrognathus	Syngnathidae	Syngnathiformes	Teleostei
Notophycis	Moridae	Gadiformes	Teleostei
Tentoriceps	Trichiuridae	Scombriformes	Teleostei
Gyrinomimus	Cetomimidae	Beryciformes	Teleostei
Synchiropus	Callionymidae	Callionymiformes	Teleostei
Halicampus	Syngnathidae	Syngnathiformes	Teleostei
Caspiosoma	Gobiidae	Gobiiformes	Teleostei
Micromesistius	Gadidae	Gadiformes	Teleostei
Cephalorhynchus	Delphinidae	Cetartiodactyla	Mammalia
Benthocometes	Ophidiidae	Ophidiiformes	Teleostei
Mogurnda	Eleotridae	Gobiiformes	Teleostei
Cyttus	Cyttidae	Zeiformes	Teleostei
Pataecus	Pataecidae	Perciformes/Scorpaenoidei	Teleostei
Halargyreus	Moridae	Gadiformes	Teleostei
Cociella	Platycephalidae	Perciformes/Scorpaenoidei	Teleostei
Owstonia	Cepolidae	Eupercaria/misc	Teleostei
Squalomugil	Mugilidae	Mugiliformes	Teleostei
Pristigaster	Pristigasteridae	Clupeiformes	Teleostei
Phasmatocottus	Cottidae	Perciformes/Cottoidei	Teleostei
Gonialosa	Dorosomatidae	Clupeiformes	Teleostei
Bathylychnops	Opisthoproctidae	Argentiniformes	Teleostei
Holtbyrnia	Platytroctidae	Alepocephaliformes	Teleostei
Hypsoblennius	Blenniidae	Blenniiformes	Teleostei
Scaturiginichthys	Pseudomugilidae	Atheriniformes	Teleostei
Atypichthys	Microcanthidae	Centrarchiformes	Teleostei
Matanui	Tripterygiidae	Blenniiformes	Teleostei
Gunnellichthys	Microdesmidae	Gobiiformes	Teleostei
Stenodus	Salmonidae	Salmoniformes	Teleostei
Coccotropsis	Tetrarogidae	Perciformes/Scorpaenoidei	Teleostei
Muraena	Muraenidae	Anguilliformes	Teleostei
Genicanthus	Pomacanthidae	Acanthuriformes	Teleostei
Paracallionymus	Callionymidae	Callionymiformes	Teleostei
Pogonoperca	Grammistidae	Perciformes/Serranoidei	Teleostei
Alopochen	Anatidae	Anseriformes	Aves
Apristurus	Pentanchidae	Carcharhiniformes	Elasmobranchii
Clupea	Clupeidae	Clupeiformes	Teleostei
Spatuloricaria	Loricariidae	Siluriformes	Teleostei
Calliclinus	Labrisomidae	Blenniiformes	Teleostei
Icosteus	Icosteidae	Scombriformes	Teleostei
Rocio	Cichlidae	Cichliformes	Teleostei
Parvilux	Myctophidae	Myctophiformes	Teleostei
Hoplostethus	Trachichthyidae	Trachichthyiformes	Teleostei
Aboma	Gobiidae	Gobiiformes	Teleostei
Kaupus	Syngnathidae	Syngnathiformes	Teleostei
Lepidopus	Trichiuridae	Scombriformes	Teleostei
Labrus	Labridae	Eupercaria/misc	Teleostei
Chriolepis	Gobiidae	Gobiiformes	Teleostei
Ptereleotris	Microdesmidae	Gobiiformes	Teleostei
Salilota	Moridae	Gadiformes	Teleostei
Stromateus	Stromateidae	Scombriformes	Teleostei
Limnotilapia	Cichlidae	Cichliformes	Teleostei
Typhlachirus	Soleidae	Pleuronectiformes	Teleostei
Bero	Cottidae	Perciformes/Cottoidei	Teleostei
Tarphops	Paralichthyidae	Pleuronectiformes	Teleostei
Crystallogobius	Gobiidae	Gobiiformes	Teleostei
Megalaspis	Carangidae	Carangiformes	Teleostei
Gibbonsia	Clinidae	Blenniiformes	Teleostei
Esselenichthys	Stichaeidae	Perciformes/Zoarcoidei	Teleostei
Amblyeleotris	Gobiidae	Gobiiformes	Teleostei
Boulengerochromis	Cichlidae	Cichliformes	Teleostei
Azygopterus	Eulophiidae	Perciformes/Zoarcoidei	Teleostei
Lamiopsis	Carcharhinidae	Carcharhiniformes	Elasmobranchii
Gadiculus	Gadidae	Gadiformes	Teleostei
Siphateles	Leuciscidae	Cypriniformes	Teleostei
Synbranchus	Synbranchidae	Synbranchiformes	Teleostei
Strophidon	Muraenidae	Anguilliformes	Teleostei
Scarus	Scaridae	Eupercaria/misc	Teleostei
Woodsia	Phosichthyidae	Stomiiformes	Teleostei
Parrella	Gobiidae	Gobiiformes	Teleostei
Austronibea	Sciaenidae	Eupercaria/misc	Teleostei
Phyllopteryx	Syngnathidae	Syngnathiformes	Teleostei
Asprocottus	Cottidae	Perciformes/Cottoidei	Teleostei
Erosa	Synanceiidae	Perciformes/Scorpaenoidei	Teleostei
Acaronia	Cichlidae	Cichliformes	Teleostei
Hydrocoloeus	Laridae	Charadriiformes	Aves
Xyrias	Ophichthidae	Anguilliformes	Teleostei
Odonteleotris	Butidae	Gobiiformes	Teleostei
Campostoma	Leuciscidae	Cypriniformes	Teleostei
Anguilla	Anguillidae	Anguilliformes	Teleostei
Cheilio	Labridae	Eupercaria/misc	Teleostei
Bryozoichthys	Stichaeidae	Perciformes/Zoarcoidei	Teleostei
Irolita	Arhynchobatidae	Rajiformes	Elasmobranchii
Hexanchus	Hexanchidae	Hexanchiformes	Elasmobranchii
Genyonemus	Sciaenidae	Eupercaria/misc	Teleostei
Exyrias	Gobiidae	Gobiiformes	Teleostei
Centroscymnus	Somniosidae	Squaliformes	Elasmobranchii
Pristiapogon	Apogonidae	Kurtiformes	Teleostei
Microgadus	Gadidae	Gadiformes	Teleostei
Sparodon	Sparidae	Eupercaria/misc	Teleostei
Stephanolepis	Monacanthidae	Tetraodontiformes	Teleostei
Cheilotrema	Sciaenidae	Eupercaria/misc	Teleostei
Fundulus	Fundulidae	Cyprinodontiformes	Teleostei
Schismorhynchus	Ophichthidae	Anguilliformes	Teleostei
Scorpaenodes	Scorpaenidae	Perciformes/Scorpaenoidei	Teleostei
Alfaro	Poeciliidae	Cyprinodontiformes	Teleostei
Amblygaster	Dorosomatidae	Clupeiformes	Teleostei
Economidichthys	Gobiidae	Gobiiformes	Teleostei
Psettichthys	Pleuronectidae	Pleuronectiformes	Teleostei
Chindongo	Cichlidae	Cichliformes	Teleostei
Paraulopus	Paraulopidae	Aulopiformes	Teleostei
Sarmarutilus	Leuciscidae	Cypriniformes	Teleostei
Cynolebias	Rivulidae	Cyprinodontiformes	Teleostei
Gilchristella	Ehiravidae	Clupeiformes	Teleostei
Narcetes	Alepocephalidae	Alepocephaliformes	Teleostei
Butis	Butidae	Gobiiformes	Teleostei
Centropomus	Centropomidae	Carangaria/misc	Teleostei
Chloroscombrus	Carangidae	Carangiformes	Teleostei
Blennophis	Clinidae	Blenniiformes	Teleostei
Peltorhamphus	Rhombosoleidae	Pleuronectiformes	Teleostei
Alepocephalus	Alepocephalidae	Alepocephaliformes	Teleostei
Silhouettea	Gobiidae	Gobiiformes	Teleostei
Ocosia	Tetrarogidae	Perciformes/Scorpaenoidei	Teleostei
Oneirodes	Oneirodidae	Lophiiformes	Teleostei
Teleocichla	Cichlidae	Cichliformes	Teleostei
Physeter	Physeteridae	Cetartiodactyla	Mammalia
Triacanthodes	Triacanthodidae	Tetraodontiformes	Teleostei
Leptoderma	Alepocephalidae	Alepocephaliformes	Teleostei
Amblypomacentrus	Pomacentridae	Ovalentaria/misc	Teleostei
Leiopotherapon	Terapontidae	Centrarchiformes	Teleostei
Isocirrhitus	Cirrhitidae	Centrarchiformes	Teleostei
Altolamprologus	Cichlidae	Cichliformes	Teleostei
Pythonichthys	Heterenchelyidae	Anguilliformes	Teleostei
Etsaputu	Loricariidae	Siluriformes	Teleostei
Buenia	Gobiidae	Gobiiformes	Teleostei
Brachaelurus	Brachaeluridae	Orectolobiformes	Elasmobranchii
Callanthias	Callanthiidae	Eupercaria/misc	Teleostei
Achiroides	Soleidae	Pleuronectiformes	Teleostei
Uraspis	Carangidae	Carangiformes	Teleostei
Xenocephalus	Uranoscopidae	Perciformes/Uranoscopoidei	Teleostei
Lagodon	Sparidae	Eupercaria/misc	Teleostei
Platyrhina	Platyrhinidae	Torpediniformes	Elasmobranchii
Membras	Atherinopsidae	Atheriniformes	Teleostei
Megadyptes	Spheniscidae	Sphenisciformes	Aves
Asemichthys	Cottidae	Perciformes/Cottoidei	Teleostei
Vanneaugobius	Gobiidae	Gobiiformes	Teleostei
Istiophorus	Istiophoridae	Carangiformes	Teleostei
Galeichthys	Ariidae	Siluriformes	Teleostei
Pseudotothyris	Loricariidae	Siluriformes	Teleostei
Brockius	Labrisomidae	Blenniiformes	Teleostei
Maurolicus	Sternoptychidae	Stomiiformes	Teleostei
Dimidiochromis	Cichlidae	Cichliformes	Teleostei
Malacocottus	Psychrolutidae	Perciformes/Cottoidei	Teleostei
Thysanichthys	Scorpaenidae	Perciformes/Scorpaenoidei	Teleostei
Platyrhinoidis	Platyrhinidae	Torpediniformes	Elasmobranchii
Potamalosa	Clupeidae	Clupeiformes	Teleostei
Decapterus	Carangidae	Carangiformes	Teleostei
Plectropomus	Epinephelidae	Perciformes/Serranoidei	Teleostei
Dicrossus	Cichlidae	Cichliformes	Teleostei
Steatocranus	Cichlidae	Cichliformes	Teleostei
Ricuzenius	Cottidae	Perciformes/Cottoidei	Teleostei
Xenojulis	Labridae	Eupercaria/misc	Teleostei
Poecilia	Poeciliidae	Cyprinodontiformes	Teleostei
Gadomus	Bathygadidae	Gadiformes	Teleostei
Scombrops	Scombropidae	Acropomatiformes	Teleostei
Kribia	Butidae	Gobiiformes	Teleostei
Optivus	Trachichthyidae	Trachichthyiformes	Teleostei
Leptonychotes	Phocidae	Carnivora	Mammalia
Taurulus	Cottidae	Perciformes/Cottoidei	Teleostei
Loweina	Myctophidae	Myctophiformes	Teleostei
Bovichtus	Bovichtidae	Perciformes/Notothenioidei	Teleostei
Ulvaria	Stichaeidae	Perciformes/Zoarcoidei	Teleostei
Gypohierax	Accipitridae	Falconiformes	Aves
Idiacanthus	Stomiidae	Stomiiformes	Teleostei
Colomesus	Tetraodontidae	Tetraodontiformes	Teleostei
Crystallias	Liparidae	Perciformes/Cottoidei	Teleostei
Panaque	Loricariidae	Siluriformes	Teleostei
Aphanius	Aphaniidae	Cyprinodontiformes	Teleostei
Priapichthys	Poeciliidae	Cyprinodontiformes	Teleostei
Polyodontes	Acoetidae	Phyllodocida	Polychaeta
Histiopterus	Pentacerotidae	Acropomatiformes	Teleostei
Caprichthys	Aracanidae	Tetraodontiformes	Teleostei
Myoxocephalus	Cottidae	Perciformes/Cottoidei	Teleostei
Icelus	Cottidae	Perciformes/Cottoidei	Teleostei
Tetrosomus	Ostraciidae	Tetraodontiformes	Teleostei
Sarotherodon	Cichlidae	Cichliformes	Teleostei
Scyliorhinus	Scyliorhinidae	Carcharhiniformes	Elasmobranchii
Halosauropsis	Halosauridae	Notacanthiformes	Teleostei
Ommatophoca	Phocidae	Carnivora	Mammalia
Trachyrhamphus	Syngnathidae	Syngnathiformes	Teleostei
Isthmoheros	Cichlidae	Cichliformes	Teleostei
Harttiella	Loricariidae	Siluriformes	Teleostei
Platygillellus	Dactyloscopidae	Blenniiformes	Teleostei
Leocottus	Cottidae	Perciformes/Cottoidei	Teleostei
Trigla	Triglidae	Perciformes/Scorpaenoidei	Teleostei
Conodon	Haemulidae	Eupercaria/misc	Teleostei
Pseudophichthys	Congridae	Anguilliformes	Teleostei
Pseudobatos	Rhinobatidae	Rhinopristiformes	Elasmobranchii
Porogadus	Ophidiidae	Ophidiiformes	Teleostei
Ambiserrula	Platycephalidae	Perciformes/Scorpaenoidei	Teleostei
Cairnsichthys	Melanotaeniidae	Atheriniformes	Teleostei
Psettina	Bothidae	Pleuronectiformes	Teleostei
Poroclinus	Lumpenidae	Perciformes/Zoarcoidei	Teleostei
Polyipnus	Sternoptychidae	Stomiiformes	Teleostei
Nematops	Poecilopsettidae	Pleuronectiformes	Teleostei
Kajikia	Istiophoridae	Carangiformes	Teleostei
Suggrundus	Platycephalidae	Perciformes/Scorpaenoidei	Teleostei
Lesueurigobius	Gobiidae	Gobiiformes	Teleostei
Lethotremus	Cyclopteridae	Perciformes/Cottoidei	Teleostei
Phallichthys	Poeciliidae	Cyprinodontiformes	Teleostei
Pseudopataecus	Aploactinidae	Perciformes/Scorpaenoidei	Teleostei
Haematopus	Charadriidae	Charadriiformes	Aves
Lipolagus	Bathylagidae	Argentiniformes	Teleostei
Caperea	Neobalaenidae	Cetartiodactyla	Mammalia
Leiodon	Tetraodontidae	Tetraodontiformes	Teleostei
Hypselognathus	Syngnathidae	Syngnathiformes	Teleostei
Hydrodamalis	Dugongidae	Sirenia	Mammalia
Laetacara	Cichlidae	Cichliformes	Teleostei
Leptagonus	Agonidae	Perciformes/Cottoidei	Teleostei
Arrhamphus	Hemiramphidae	Beloniformes	Teleostei
Galeoides	Polynemidae	Carangaria/misc	Teleostei
Chaetostoma	Loricariidae	Siluriformes	Teleostei
Podothecus	Agonidae	Perciformes/Cottoidei	Teleostei
Lipogenys	Notacanthidae	Notacanthiformes	Teleostei
Lindbergichthys	Nototheniidae	Perciformes	Teleostei
Centriscops	Centriscidae	Syngnathiformes	Teleostei
Trigonectes	Rivulidae	Cyprinodontiformes	Teleostei
Aldrovandia	Halosauridae	Notacanthiformes	Teleostei
Chesnonia	Agonidae	Perciformes/Cottoidei	Teleostei
Kuiterichthys	Histiophrynidae	Lophiiformes	Teleostei
Draconetta	Draconettidae	Callionymiformes	Teleostei
Gymnogobius	Gobiidae	Gobiiformes	Teleostei
Nessorhamphus	Derichthyidae	Anguilliformes	Teleostei
Chlidonias	Laridae	Charadriiformes	Aves
Coris	Labridae	Eupercaria/misc	Teleostei
Entosphenus	Petromyzontidae	Petromyzontiformes	Petromyzonti
Latridopsis	Latridae	Centrarchiformes	Teleostei
Sutorectus	Orectolobidae	Orectolobiformes	Elasmobranchii
Nettastoma	Nettastomatidae	Anguilliformes	Teleostei
Elattarchus	Sciaenidae	Eupercaria/misc	Teleostei
Ichthyscopus	Uranoscopidae	Perciformes/Uranoscopoidei	Teleostei
Mesocottus	Cottidae	Perciformes/Cottoidei	Teleostei
Oxylebius	Zaniolepididae	Perciformes/Cottoidei	Teleostei
Trachelochismus	Gobiesocidae	Gobiesociformes	Teleostei
Glossamia	Apogonidae	Kurtiformes	Teleostei
Pernis	Accipitridae	Falconiformes	Aves
Goniistius	Latridae	Centrarchiformes	Teleostei
Ostichthys	Holocentridae	Holocentriformes	Teleostei
Brachymystax	Salmonidae	Salmoniformes	Teleostei
Anodontostoma	Dorosomatidae	Clupeiformes	Teleostei
Oblada	Sparidae	Eupercaria/misc	Teleostei
Latropiscis	Aulopidae	Aulopiformes	Teleostei
Apletodon	Gobiesocidae	Gobiesociformes	Teleostei
Risor	Gobiidae	Gobiiformes	Teleostei
Gaidropsarus	Gaidropsaridae	Gadiformes	Teleostei
Sorsogona	Platycephalidae	Perciformes/Scorpaenoidei	Teleostei
Eurypharynx	Eurypharyngidae	Saccopharyngiformes	Teleostei
Torpedo	Torpedinidae	Torpediniformes	Elasmobranchii
Xystreurys	Paralichthyidae	Pleuronectiformes	Teleostei
Oostethus	Syngnathidae	Syngnathiformes	Teleostei
Neenchelys	Ophichthidae	Anguilliformes	Teleostei
Pangasianodon	Pangasiidae	Siluriformes	Teleostei
Brosme	Lotidae	Gadiformes	Teleostei
Melanochromis	Cichlidae	Cichliformes	Teleostei
Parapocryptes	Oxudercidae	Gobiiformes	Teleostei
Antilligobius	Gobiidae	Gobiiformes	Teleostei
Gollum	Pseudotriakidae	Carcharhiniformes	Elasmobranchii
Oxuderces	Oxudercidae	Gobiiformes	Teleostei
Stolephorus	Engraulidae	Clupeiformes	Teleostei
Aulacocephalus	Liopropomatidae	Perciformes/Serranoidei	Teleostei
Clevelandia	Gobiidae	Gobiiformes	Teleostei
Oligocottus	Cottidae	Perciformes/Cottoidei	Teleostei
Pentaceropsis	Pentacerotidae	Acropomatiformes	Teleostei
Indopacetus	Ziphiidae	Cetartiodactyla	Mammalia
Ketengus	Ariidae	Siluriformes	Teleostei
Eubalichthys	Monacanthidae	Tetraodontiformes	Teleostei
Echinorhinus	Echinorhinidae	Echinorhiniformes	Elasmobranchii
Alphestes	Epinephelidae	Perciformes/Serranoidei	Teleostei
Dicrolene	Ophidiidae	Ophidiiformes	Teleostei
Pariolius	Heptapteridae	Siluriformes	Teleostei
Paraploactis	Aploactinidae	Perciformes/Scorpaenoidei	Teleostei
Sagamichthys	Platytroctidae	Alepocephaliformes	Teleostei
Paratrachichthys	Trachichthyidae	Trachichthyiformes	Teleostei
Pseudomugil	Pseudomugilidae	Atheriniformes	Teleostei
Urobatis	Urotrygonidae	Myliobatiformes	Elasmobranchii
Oligolepis	Gobiidae	Gobiiformes	Teleostei
Malakichthys	Malakichthyidae	Acropomatiformes	Teleostei
Campogramma	Carangidae	Carangiformes	Teleostei
Platygobio	Leuciscidae	Cypriniformes	Teleostei
Cantheschenia	Monacanthidae	Tetraodontiformes	Teleostei
Petalichthys	Belonidae	Beloniformes	Teleostei
Alloclinus	Labrisomidae	Blenniiformes	Teleostei
Psilotris	Gobiidae	Gobiiformes	Teleostei
Sterna	Laridae	Charadriiformes	Aves
Cleithracara	Cichlidae	Cichliformes	Teleostei
Prionotus	Triglidae	Perciformes/Scorpaenoidei	Teleostei
Microcanthus	Microcanthidae	Centrarchiformes	Teleostei
Thaleichthys	Osmeridae	Osmeriformes	Teleostei
Bathygobius	Gobiidae	Gobiiformes	Teleostei
Pseudambassis	Ambassidae	Ovalentaria/misc	Teleostei
Parmaturus	Pentanchidae	Carcharhiniformes	Elasmobranchii
Salariopsis	Blenniidae	Blenniiformes	Teleostei
Sicyases	Gobiesocidae	Gobiesociformes	Teleostei
Mitsukurina	Mitsukurinidae	Lamniformes	Elasmobranchii
Neamia	Apogonidae	Kurtiformes	Teleostei
Phaeoptyx	Apogonidae	Kurtiformes	Teleostei
Engyophrys	Bothidae	Pleuronectiformes	Teleostei
Aploactis	Aploactinidae	Perciformes/Scorpaenoidei	Teleostei
Tosana	Anthiadidae	Perciformes/Serranoidei	Teleostei
Prognatholiparis	Liparidae	Perciformes/Cottoidei	Teleostei
Larosterna	Laridae	Charadriiformes	Aves
Chlorophthalmus	Chlorophthalmidae	Aulopiformes	Teleostei
Hemieleotris	Eleotridae	Gobiiformes	Teleostei
Chanda	Ambassidae	Ovalentaria/misc	Teleostei
Erythrinus	Erythrinidae	Characiformes	Teleostei
Cyclichthys	Diodontidae	Tetraodontiformes	Teleostei
Paristiopterus	Pentacerotidae	Acropomatiformes	Teleostei
Craterocephalus	Atherinidae	Atheriniformes	Teleostei
Venefica	Nettastomatidae	Anguilliformes	Teleostei
Neodraco	Artedidraconidae	Perciformes/Notothenioidei	Teleostei
Lamontichthys	Loricariidae	Siluriformes	Teleostei
Chloephaga	Anatidae	Anseriformes	Aves
Cualac	Cyprinodontidae	Cyprinodontiformes	Teleostei
Grammatostomias	Stomiidae	Stomiiformes	Teleostei
Nesofregetta	Hydrobatidae	Procellariiformes	Aves
Davidijordania	Zoarcidae	Perciformes/Zoarcoidei	Teleostei
Anomalops	Anomalopidae	Trachichthyiformes	Teleostei
Myxodagnus	Dactyloscopidae	Blenniiformes	Teleostei
Calumia	Eleotridae	Gobiiformes	Teleostei
Psammobatis	Arhynchobatidae	Rajiformes	Elasmobranchii
Malacoctenus	Labrisomidae	Blenniiformes	Teleostei
Trichiurus	Trichiuridae	Scombriformes	Teleostei
Pseudechidna	Muraenidae	Anguilliformes	Teleostei
Megalops	Megalopidae	Elopiformes	Teleostei
Theristicus	Threskiornithidae	Ciconiiformes	Aves
Orectolobus	Orectolobidae	Orectolobiformes	Elasmobranchii
Atherina	Atherinidae	Atheriniformes	Teleostei
Forcipiger	Chaetodontidae	Acanthuriformes	Teleostei
Pallasina	Agonidae	Perciformes/Cottoidei	Teleostei
Nannoplecostomus	Loricariidae	Siluriformes	Teleostei
Osteogeneiosus	Ariidae	Siluriformes	Teleostei
Gobiesox	Gobiesocidae	Gobiesociformes	Teleostei
Lappanella	Labridae	Eupercaria/misc	Teleostei
Magadanichthys	Zoarcidae	Perciformes/Zoarcoidei	Teleostei
Chromis	Pomacentridae	Ovalentaria/misc	Teleostei
Aioliops	Microdesmidae	Gobiiformes	Teleostei
Philypnodon	Eleotridae	Gobiiformes	Teleostei
Neovespicula	Tetrarogidae	Perciformes/Scorpaenoidei	Teleostei
Neotrygon	Dasyatidae	Myliobatiformes	Elasmobranchii
Limanda	Pleuronectidae	Pleuronectiformes	Teleostei
Paracaesio	Lutjanidae	Eupercaria/misc	Teleostei
Rostroraja	Rajidae	Rajiformes	Elasmobranchii
Gerlachea	Bathydraconidae	Perciformes/Notothenioidei	Teleostei
Lates	Latidae	Carangaria/misc	Teleostei
Rosenblattia	Epigonidae	Acropomatiformes	Teleostei
Paraplagusia	Cynoglossidae	Pleuronectiformes	Teleostei
Stlengis	Cottidae	Perciformes/Cottoidei	Teleostei
Ophichthus	Ophichthidae	Anguilliformes	Teleostei
Erilepis	Anoplopomatidae	Perciformes/Cottoidei	Teleostei
Camptorhynchus	Anatidae	Anseriformes	Aves
Citharoides	Citharidae	Pleuronectiformes	Teleostei
Borostomias	Stomiidae	Stomiiformes	Teleostei
Cryothenia	Nototheniidae	Perciformes	Teleostei
Prototroctes	Retropinnidae	Osmeriformes	Teleostei
Xiphias	Xiphiidae	Carangiformes	Teleostei
Aethotaxis	Nototheniidae	Perciformes/Notothenioidei	Teleostei
Hypsopsetta	Pleuronectidae	Pleuronectiformes	Teleostei
Ctenolabrus	Labridae	Eupercaria/misc	Teleostei
Hyporhamphus	Hemiramphidae	Beloniformes	Teleostei
Aix	Anatidae	Anseriformes	Aves
Pleuronectes	Pleuronectidae	Pleuronectiformes	Teleostei
Odax	Odacidae	Eupercaria/misc	Teleostei
Stereolepis	Stereolepididae	Acropomatiformes	Teleostei
Verasper	Pleuronectidae	Pleuronectiformes	Teleostei
Echiichthys	Trachinidae	Perciformes/Percoidei	Teleostei
Siphonognathus	Odacidae	Eupercaria/misc	Teleostei
Apagesoma	Ophidiidae	Ophidiiformes	Teleostei
Xenophthalmichthys	Microstomatidae	Argentiniformes	Teleostei
Lepidonotothen	Nototheniidae	Perciformes/Notothenioidei	Teleostei
Doratonotus	Labridae	Eupercaria/misc	Teleostei
Amamiichthys	Sparidae	Eupercaria/misc	Teleostei
Floridichthys	Cyprinodontidae	Cyprinodontiformes	Teleostei
Brochiraja	Arhynchobatidae	Rajiformes	Elasmobranchii
Transancistrus	Loricariidae	Siluriformes	Teleostei
Pseudaesopia	Soleidae	Pleuronectiformes	Teleostei
Xeneretmus	Agonidae	Perciformes/Cottoidei	Teleostei
Squaliolus	Dalatiidae	Squaliformes	Elasmobranchii
Typhleotris	Milyeringidae	Gobiiformes	Teleostei
Phenacorhamdia	Heptapteridae	Siluriformes	Teleostei
Zanclus	Zanclidae	Acanthuriformes	Teleostei
Racovitzia	Bathydraconidae	Perciformes/Notothenioidei	Teleostei
Galaxiella	Galaxiidae	Galaxiiformes	Teleostei
Ranzania	Molidae	Tetraodontiformes	Teleostei
Pomacentrus	Pomacentridae	Ovalentaria/misc	Teleostei
Centroscyllium	Etmopteridae	Squaliformes	Elasmobranchii
Haptenchelys	Synaphobranchidae	Anguilliformes	Teleostei
Derichthys	Derichthyidae	Anguilliformes	Teleostei
Liachirus	Soleidae	Pleuronectiformes	Teleostei
Ammodytoides	Ammodytidae	Perciformes/Uranoscopoidei	Teleostei
Schedophilus	Centrolophidae	Scombriformes	Teleostei
Ziphius	Ziphiidae	Cetartiodactyla	Mammalia
Notomuraenobathys	Muraenolepididae	Gadiformes	Teleostei
Pterosturisoma	Loricariidae	Siluriformes	Teleostei
Hyperoodon	Ziphiidae	Cetartiodactyla	Mammalia
Isogomphodon	Carcharhinidae	Carcharhiniformes	Elasmobranchii
Neogobius	Gobiidae	Gobiiformes	Teleostei
Papasula	Sulidae	Pelecaniformes	Aves
Leviprora	Platycephalidae	Perciformes/Scorpaenoidei	Teleostei
Amphelikturus	Syngnathidae	Syngnathiformes	Teleostei
Mycteroperca	Epinephelidae	Perciformes/Serranoidei	Teleostei
Exallias	Blenniidae	Blenniiformes	Teleostei
Tilodon	Microcanthidae	Centrarchiformes	Teleostei
Atropus	Carangidae	Carangiformes	Teleostei
Minimugil	Mugilidae	Mugiliformes	Teleostei
Hemitriakis	Triakidae	Carcharhiniformes	Elasmobranchii
Enoplosus	Enoplosidae	Centrarchiformes	Teleostei
Heterotilapia	Cichlidae	Cichliformes	Teleostei
Amatitlania	Cichlidae	Cichliformes	Teleostei
Alabes	Gobiesocidae	Gobiesociformes	Teleostei
Stanulus	Blenniidae	Blenniiformes	Teleostei
Congresox	Muraenesocidae	Anguilliformes	Teleostei
Hephaestus	Terapontidae	Centrarchiformes	Teleostei
Tautogolabrus	Labridae	Eupercaria/misc	Teleostei
Nimbochromis	Cichlidae	Cichliformes	Teleostei
Hieraaetus	Accipitridae	Falconiformes	Aves
Melanotaenia	Melanotaeniidae	Atheriniformes	Teleostei
Pseudoloricaria	Loricariidae	Siluriformes	Teleostei
Pseudomyxus	Mugilidae	Mugiliformes	Teleostei
Assurger	Trichiuridae	Scombriformes	Teleostei
Tragulichthys	Diodontidae	Tetraodontiformes	Teleostei
Xenolepidichthys	Grammicolepididae	Zeiformes	Teleostei
Eptatretus	Myxinidae	Myxiniformes	Myxini
Tetraodon	Tetraodontidae	Tetraodontiformes	Teleostei
Nannosalarias	Blenniidae	Blenniiformes	Teleostei
Pterengraulis	Engraulidae	Clupeiformes	Teleostei
Ebosia	Scorpaenidae	Perciformes/Scorpaenoidei	Teleostei
Fodiator	Exocoetidae	Beloniformes	Teleostei
Taaningichthys	Myctophidae	Myctophiformes	Teleostei
Iniistius	Labridae	Eupercaria/misc	Teleostei
Hyperoplus	Ammodytidae	Perciformes/Uranoscopoidei	Teleostei
Pachymetopon	Sparidae	Eupercaria/misc	Teleostei
Pseudoplesiops	Pseudochromidae	Ovalentaria/misc	Teleostei
Creocele	Gobiesocidae	Gobiesociformes	Teleostei
Auchenionchus	Labrisomidae	Blenniiformes	Teleostei
Dolichosudis	Paralepididae	Aulopiformes	Teleostei
Amioides	Apogonidae	Kurtiformes	Teleostei
Haemulopsis	Haemulidae	Eupercaria/misc	Teleostei
Lovettia	Galaxiidae	Galaxiiformes	Teleostei
Gordiichthys	Ophichthidae	Anguilliformes	Teleostei
Myripristis	Holocentridae	Holocentriformes	Teleostei
Icichthys	Centrolophidae	Scombriformes	Teleostei
Tactostoma	Stomiidae	Stomiiformes	Teleostei
Springerichthys	Tripterygiidae	Blenniiformes	Teleostei
Pampus	Stromateidae	Scombriformes	Teleostei
Notomyxine	Myxinidae	Myxiniformes	Myxini
Microplecostomus	Loricariidae	Siluriformes	Teleostei
Heroina	Cichlidae	Cichliformes	Teleostei
Notopogon	Centriscidae	Syngnathiformes	Teleostei
Aphos	Batrachoididae	Batrachoidiformes	Teleostei
Lethrinus	Lethrinidae	Eupercaria/misc	Teleostei
Pyrolycus	Zoarcidae	Perciformes/Zoarcoidei	Teleostei
Dionda	Leuciscidae	Cypriniformes	Teleostei
Heptranchias	Hexanchidae	Hexanchiformes	Elasmobranchii
Notarius	Ariidae	Siluriformes	Teleostei
Tachyeres	Anatidae	Anseriformes	Aves
Eurypleuron	Carapidae	Ophidiiformes	Teleostei
Sundasalanx	Ehiravidae	Clupeiformes	Teleostei
Bathymicrops	Ipnopidae	Aulopiformes	Teleostei
Pagrus	Sparidae	Eupercaria/misc	Teleostei
Lophogobius	Gobiidae	Gobiiformes	Teleostei
Cyclothone	Gonostomatidae	Stomiiformes	Teleostei
Pseudohemiodon	Loricariidae	Siluriformes	Teleostei
Lonchurus	Sciaenidae	Eupercaria/misc	Teleostei
Ratabulus	Platycephalidae	Perciformes/Scorpaenoidei	Teleostei
Centroselachus	Somniosidae	Squaliformes	Elasmobranchii
Aquila	Accipitridae	Falconiformes	Aves
Speleogobius	Gobiidae	Gobiiformes	Teleostei
Plesiops	Plesiopidae	Ovalentaria/misc	Teleostei
Pagothenia	Nototheniidae	Perciformes/Notothenioidei	Teleostei
Dendrocygna	Anatidae	Anseriformes	Aves
Emblemaria	Chaenopsidae	Blenniiformes	Teleostei
Ribeiroclinus	Clinidae	Blenniiformes	Teleostei
Kihnichthys	Cichlidae	Cichliformes	Teleostei
Harengula	Dorosomatidae	Clupeiformes	Teleostei
Macrorhamphosodes	Triacanthodidae	Tetraodontiformes	Teleostei
Hologymnosus	Labridae	Eupercaria/misc	Teleostei
Hypanus	Dasyatidae	Myliobatiformes	Elasmobranchii
Sierrathrissa	Dorosomatidae	Clupeiformes	Teleostei
Scorpaena	Scorpaenidae	Perciformes/Scorpaenoidei	Teleostei
Tasmacetus	Ziphiidae	Cetartiodactyla	Mammalia
Parvicrepis	Gobiesocidae	Gobiesociformes	Teleostei
Paraneetroplus	Cichlidae	Cichliformes	Teleostei
Sebastes	Sebastidae	Perciformes/Scorpaenoidei	Teleostei
Cyphotilapia	Cichlidae	Cichliformes	Teleostei
Chlopsis	Chlopsidae	Anguilliformes	Teleostei
Cyclopsetta	Cyclopsettidae	Pleuronectiformes	Teleostei
Phaetusa	Laridae	Charadriiformes	Aves
Cubiceps	Nomeidae	Scombriformes	Teleostei
Lampetra	Petromyzontidae	Petromyzontiformes	Petromyzonti
Pithecophaga	Accipitridae	Falconiformes	Aves
Buccochromis	Cichlidae	Cichliformes	Teleostei
Chatrabus	Batrachoididae	Batrachoidiformes	Teleostei
Maroubra	Syngnathidae	Syngnathiformes	Teleostei
Genyagnus	Uranoscopidae	Perciformes/Uranoscopoidei	Teleostei
Micropoecilia	Poeciliidae	Cyprinodontiformes	Teleostei
Feresa	Delphinidae	Cetartiodactyla	Mammalia
Scymnodalatias	Somniosidae	Squaliformes	Elasmobranchii
Pterolebias	Rivulidae	Cyprinodontiformes	Teleostei
Xenentodon	Belonidae	Beloniformes	Teleostei
Lepidotrigla	Triglidae	Perciformes/Scorpaenoidei	Teleostei
Heterotis	Arapaimidae	Osteoglossiformes	Teleostei
Bonapartia	Gonostomatidae	Stomiiformes	Teleostei
Rhina	Rhinidae	Rhinopristiformes	Elasmobranchii
Ophthalmolebias	Rivulidae	Cyprinodontiformes	Teleostei
Lepidomeda	Leuciscidae	Cypriniformes	Teleostei
Ophthalmolepis	Labridae	Eupercaria/misc	Teleostei
Zebrias	Soleidae	Pleuronectiformes	Teleostei
Ardea	Ardeidae	Ciconiiformes	Aves
Gymnocanthus	Cottidae	Perciformes/Cottoidei	Teleostei
Balistes	Balistidae	Tetraodontiformes	Teleostei
Ophiclinops	Clinidae	Blenniiformes	Teleostei
Parkraemeria	Gobiidae	Gobiiformes	Teleostei
Pellonula	Dorosomatidae	Clupeiformes	Teleostei
Chasmodes	Blenniidae	Blenniiformes	Teleostei
Tripodichthys	Triacanthidae	Tetraodontiformes	Teleostei
Choridactylus	Synanceiidae	Perciformes/Scorpaenoidei	Teleostei
Hexanematichthys	Ariidae	Siluriformes	Teleostei
Plecodus	Cichlidae	Cichliformes	Teleostei
Bathycongrus	Congridae	Anguilliformes	Teleostei
Evynnis	Sparidae	Eupercaria/misc	Teleostei
Psychrolutes	Psychrolutidae	Perciformes/Cottoidei	Teleostei
Petenia	Cichlidae	Cichliformes	Teleostei
Schismatogobius	Gobiidae	Gobiiformes	Teleostei
Neocirrhites	Cirrhitidae	Centrarchiformes	Teleostei
Poroderma	Scyliorhinidae	Carcharhiniformes	Elasmobranchii
Eupleurogrammus	Trichiuridae	Scombriformes	Teleostei
Lissocampus	Syngnathidae	Syngnathiformes	Teleostei
Marleyella	Poecilopsettidae	Pleuronectiformes	Teleostei
Gymnogeophagus	Cichlidae	Cichliformes	Teleostei
Bathyagonus	Agonidae	Perciformes/Cottoidei	Teleostei
Psenes	Nomeidae	Scombriformes	Teleostei
Bellottia	Bythitidae	Ophidiiformes	Teleostei
Melichthys	Balistidae	Tetraodontiformes	Teleostei
Poecilopsetta	Poecilopsettidae	Pleuronectiformes	Teleostei
Eucinostomus	Gerreidae	Eupercaria/misc	Teleostei
Zaprora	Zaproridae	Perciformes/Zoarcoidei	Teleostei
Ptychochromoides	Cichlidae	Cichliformes	Teleostei
Atrosalarias	Blenniidae	Blenniiformes	Teleostei
Ogilbichthys	Dinematichthyidae	Ophidiiformes	Teleostei
Pseudotocinclus	Loricariidae	Siluriformes	Teleostei
Ponticola	Gobiidae	Gobiiformes	Teleostei
Oplegnathus	Oplegnathidae	Centrarchiformes	Teleostei
Acentrophryne	Linophrynidae	Lophiiformes	Teleostei
Cinetodus	Ariidae	Siluriformes	Teleostei
Rhinogobiops	Gobiidae	Gobiiformes	Teleostei
Plecoglossus	Plecoglossidae	Osmeriformes	Teleostei
Cebidichthys	Cebidichthyidae	Perciformes/Zoarcoidei	Teleostei
Dibrachichthys	Tetrabrachiidae	Lophiiformes	Teleostei
Myaka	Cichlidae	Cichliformes	Teleostei
Embiotoca	Embiotocidae	Ovalentaria/misc	Teleostei
Cunningtonia	Cichlidae	Cichliformes	Teleostei
Nuchequula	Leiognathidae	Acanthuriformes	Teleostei
Chaetobranchopsis	Cichlidae	Cichliformes	Teleostei
Notacanthus	Notacanthidae	Notacanthiformes	Teleostei
Scortum	Terapontidae	Centrarchiformes	Teleostei
Trimmatom	Gobiidae	Gobiiformes	Teleostei
Lethenteron	Petromyzontidae	Petromyzontiformes	Petromyzonti
Trematomus	Nototheniidae	Perciformes/Notothenioidei	Teleostei
Aplodinotus	Sciaenidae	Eupercaria/misc	Teleostei
Linophryne	Linophrynidae	Lophiiformes	Teleostei
Valenciennea	Gobiidae	Gobiiformes	Teleostei
Pinjalo	Lutjanidae	Eupercaria/misc	Teleostei
Corniger	Holocentridae	Holocentriformes	Teleostei
Haplocylix	Gobiesocidae	Gobiesociformes	Teleostei
Pseudoliparis	Liparidae	Perciformes/Cottoidei	Teleostei
Orthochromis	Cichlidae	Cichliformes	Teleostei
Paraheminodus	Peristediidae	Perciformes/Scorpaenoidei	Teleostei
Eurypegasus	Pegasidae	Dactylopteriformes	Teleostei
Alticus	Blenniidae	Blenniiformes	Teleostei
Setipinna	Engraulidae	Clupeiformes	Teleostei
Evermannichthys	Gobiidae	Gobiiformes	Teleostei
Triphoturus	Myctophidae	Myctophiformes	Teleostei
Lagusia	Terapontidae	Centrarchiformes	Teleostei
Cristatogobius	Gobiidae	Gobiiformes	Teleostei
Maulisia	Platytroctidae	Alepocephaliformes	Teleostei
Phycodurus	Syngnathidae	Syngnathiformes	Teleostei
Pelasgus	Leuciscidae	Cypriniformes	Teleostei
Phalacrocorax	Phalacrocoracidae	Pelecaniformes	Aves
Citharus	Citharidae	Pleuronectiformes	Teleostei
Nipponia	Threskiornithidae	Ciconiiformes	Aves
Guentherus	Ateleopodidae	Ateleopodiformes	Teleostei
Otaria	Otariidae	Carnivora	Mammalia
Egglestonichthys	Gobiidae	Gobiiformes	Teleostei
Centrarchops	Dinopercidae	Eupercaria/misc	Teleostei
Wetmorella	Labridae	Eupercaria/misc	Teleostei
Scoliodon	Carcharhinidae	Carcharhiniformes	Elasmobranchii
Cremnochorites	Tripterygiidae	Blenniiformes	Teleostei
Ratsirakia	Eleotridae	Gobiiformes	Teleostei
Hime	Aulopidae	Aulopiformes	Teleostei
Antimora	Moridae	Gadiformes	Teleostei
Azygopus	Rhombosoleidae	Pleuronectiformes	Teleostei
Guyanancistrus	Loricariidae	Siluriformes	Teleostei
Coelophrys	Ogcocephalidae	Lophiiformes	Teleostei
Rhinobatos	Rhinobatidae	Rhinopristiformes	Elasmobranchii
Acanthicus	Loricariidae	Siluriformes	Teleostei
Cabillus	Gobiidae	Gobiiformes	Teleostei
Tropidophoxinellus	Leuciscidae	Cypriniformes	Teleostei
Priacanthus	Priacanthidae	Eupercaria/misc	Teleostei
Calidris	Scolopacidae	Charadriiformes	Aves
Pseudosciades	Ariidae	Siluriformes	Teleostei
Margariscus	Leuciscidae	Cypriniformes	Teleostei
Hozukius	Sebastidae	Perciformes/Scorpaenoidei	Teleostei
Lubbockichthys	Pseudochromidae	Ovalentaria/misc	Teleostei
Cryptotomus	Scaridae	Eupercaria/misc	Teleostei
Symphurus	Cynoglossidae	Pleuronectiformes	Teleostei
Pristiophorus	Pristiophoridae	Pristiophoriformes	Elasmobranchii
Bathymaster	Bathymasteridae	Perciformes/Zoarcoidei	Teleostei
Tigrigobius	Gobiidae	Gobiiformes	Teleostei
Spiniraja	Rajidae	Rajiformes	Elasmobranchii
Gymnochanda	Ambassidae	Ovalentaria/misc	Teleostei
Hydrolagus	Chimaeridae	Chimaeriformes	Holocephali
Himantolophus	Himantolophidae	Lophiiformes	Teleostei
Molva	Lotidae	Gadiformes	Teleostei
Diplospinus	Gempylidae	Scombriformes	Teleostei
Cnesterodon	Poeciliidae	Cyprinodontiformes	Teleostei
Pseudocaranx	Carangidae	Carangiformes	Teleostei
Nebrius	Ginglymostomatidae	Orectolobiformes	Elasmobranchii
Tylochromis	Cichlidae	Cichliformes	Teleostei
Eumicrotremus	Cyclopteridae	Perciformes/Cottoidei	Teleostei
Flagellostomias	Stomiidae	Stomiiformes	Teleostei
Acanthocybium	Scombridae	Scombriformes	Teleostei
Pictichromis	Pseudochromidae	Ovalentaria/misc	Teleostei
Mustelus	Triakidae	Carcharhiniformes	Elasmobranchii
Lobulogobius	Gobiidae	Gobiiformes	Teleostei
Chrysoblephus	Sparidae	Eupercaria/misc	Teleostei
Lycodapus	Zoarcidae	Perciformes/Zoarcoidei	Teleostei
Cyprinella	Leuciscidae	Cypriniformes	Teleostei
Giganthias	Anthiadidae	Perciformes/Serranoidei	Teleostei
Porocottus	Cottidae	Perciformes/Cottoidei	Teleostei
Acanthemblemaria	Chaenopsidae	Blenniiformes	Teleostei
Cepola	Cepolidae	Eupercaria/misc	Teleostei
Bufoceratias	Diceratiidae	Lophiiformes	Teleostei
Scuticaria	Muraenidae	Anguilliformes	Teleostei
Batrichthys	Batrachoididae	Batrachoidiformes	Teleostei
Tandanus	Plotosidae	Siluriformes	Teleostei
Bidenichthys	Bythitidae	Ophidiiformes	Teleostei
Ascelichthys	Cottidae	Perciformes/Cottoidei	Teleostei
Scorpis	Scorpididae	Centrarchiformes	Teleostei
Syacium	Cyclopsettidae	Pleuronectiformes	Teleostei
Harpagifer	Harpagiferidae	Perciformes/Notothenioidei	Teleostei
Pao	Tetraodontidae	Tetraodontiformes	Teleostei
Benthosema	Myctophidae	Myctophiformes	Teleostei
Blepsias	Agonidae	Perciformes/Cottoidei	Teleostei
Parascolopsis	Nemipteridae	Eupercaria/misc	Teleostei
Pristotis	Pomacentridae	Ovalentaria/misc	Teleostei
Petrotilapia	Cichlidae	Cichliformes	Teleostei
Allosmerus	Osmeridae	Osmeriformes	Teleostei
Gymnothorax	Muraenidae	Anguilliformes	Teleostei
Cyrtocara	Cichlidae	Cichliformes	Teleostei
Exocoetus	Exocoetidae	Beloniformes	Teleostei
Velifer	Veliferidae	Lampriformes	Teleostei
Equulites	Leiognathidae	Acanthuriformes	Teleostei
Zalembius	Embiotocidae	Ovalentaria/misc	Teleostei
Rosenblattichthys	Scopelarchidae	Aulopiformes	Teleostei
Isurus	Lamnidae	Lamniformes	Elasmobranchii
Spectrunculus	Ophidiidae	Ophidiiformes	Teleostei
Remora	Echeneidae	Carangiformes	Teleostei
Lampichthys	Myctophidae	Myctophiformes	Teleostei
Cephalopholis	Epinephelidae	Perciformes/Serranoidei	Teleostei
Paralichthys	Paralichthyidae	Pleuronectiformes	Teleostei
Neoaploactis	Aploactinidae	Perciformes/Scorpaenoidei	Teleostei
Cleisthenes	Pleuronectidae	Pleuronectiformes	Teleostei
Pentanemus	Polynemidae	Carangaria/misc	Teleostei
Uria	Alcidae	Charadriiformes	Aves
Akihito	Gobiidae	Gobiiformes	Teleostei
Leucaspius	Leuciscidae	Cypriniformes	Teleostei
Encheliophis	Carapidae	Ophidiiformes	Teleostei
Lythrichthys	Setarchidae	Perciformes/Scorpaenoidei	Teleostei
Helcogrammoides	Tripterygiidae	Blenniiformes	Teleostei
Parabathymyrus	Congridae	Anguilliformes	Teleostei
Oncorhynchus	Salmonidae	Salmoniformes	Teleostei
Chiloconger	Congridae	Anguilliformes	Teleostei
Stethopristes	Parazenidae	Zeiformes	Teleostei
Ctenochaetus	Acanthuridae	Acanthuriformes	Teleostei
Karalepis	Tripterygiidae	Blenniiformes	Teleostei
Arctocephalus	Otariidae	Carnivora	Mammalia
Agamia	Ardeidae	Ciconiiformes	Aves
Odontomacrurus	Macrouridae	Gadiformes	Teleostei
Erythrogonys	Charadriidae	Charadriiformes	Aves
Oncopterus	Oncopteridae	Pleuronectiformes	Teleostei
Aythya	Anatidae	Anseriformes	Aves
Lipogramma	Grammatidae	Ovalentaria/misc	Teleostei
Odontamblyopus	Gobiidae	Gobiiformes	Teleostei
Arnoglossus	Bothidae	Pleuronectiformes	Teleostei
Bathygadus	Bathygadidae	Gadiformes	Teleostei
Seriola	Carangidae	Carangiformes	Teleostei
Hemiramphus	Hemiramphidae	Beloniformes	Teleostei
Odontoscion	Sciaenidae	Eupercaria/misc	Teleostei
Oxyurichthys	Gobiidae	Gobiiformes	Teleostei
Winteria	Opisthoproctidae	Argentiniformes	Teleostei
Chionodraco	Channichthyidae	Perciformes/Notothenioidei	Teleostei
Heteroconger	Congridae	Anguilliformes	Teleostei
Zeugopterus	Scophthalmidae	Pleuronectiformes	Teleostei
Halidesmus	Pseudochromidae	Ovalentaria/misc	Teleostei
Pachyurus	Sciaenidae	Eupercaria/misc	Teleostei
Spratelloides	Spratelloididae	Clupeiformes	Teleostei
Neochelon	Mugilidae	Mugiliformes	Teleostei
Oxyura	Anatidae	Anseriformes	Aves
Ramnogaster	Clupeidae	Clupeiformes	Teleostei
Nannocampus	Syngnathidae	Syngnathiformes	Teleostei
Ulaema	Gerreidae	Eupercaria/misc	Teleostei
Posidonichthys	Gobiesocidae	Gobiesociformes	Teleostei
Selenanthias	Anthiadidae	Perciformes/Serranoidei	Teleostei
Cypho	Pseudochromidae	Ovalentaria/misc	Teleostei
Pardachirus	Soleidae	Pleuronectiformes	Teleostei
Paratilapia	Cichlidae	Cichliformes	Teleostei
Rhyacichthys	Rhyacichthyidae	Gobiiformes	Teleostei
Arctoraja	Arhynchobatidae	Rajiformes	Elasmobranchii
Carcharias	Carchariidae	Lamniformes	Elasmobranchii
Pinguinus	Alcidae	Charadriiformes	Aves
Snyderina	Tetrarogidae	Perciformes/Scorpaenoidei	Teleostei
Sebastiscus	Sebastidae	Perciformes/Scorpaenoidei	Teleostei
Chaetobranchus	Cichlidae	Cichliformes	Teleostei
Brotulotaenia	Ophidiidae	Ophidiiformes	Teleostei
Bathycallionymus	Callionymidae	Callionymiformes	Teleostei
Raconda	Pristigasteridae	Clupeiformes	Teleostei
Cryptocentrus	Gobiidae	Gobiiformes	Teleostei
Rhynchoconger	Congridae	Anguilliformes	Teleostei
Gargariscus	Peristediidae	Perciformes/Scorpaenoidei	Teleostei
Taenianotus	Scorpaenidae	Perciformes/Scorpaenoidei	Teleostei
Abramis	Leuciscidae	Cypriniformes	Teleostei
Capropygia	Aracanidae	Tetraodontiformes	Teleostei
Monopenchelys	Muraenidae	Anguilliformes	Teleostei
Praealticus	Blenniidae	Blenniiformes	Teleostei
Chondrostoma	Leuciscidae	Cypriniformes	Teleostei
Curculionichthys	Loricariidae	Siluriformes	Teleostei
Assessor	Plesiopidae	Ovalentaria/misc	Teleostei
Gephyroberyx	Trachichthyidae	Trachichthyiformes	Teleostei
Hexatrygon	Hexatrygonidae	Myliobatiformes	Elasmobranchii
Pareiorhaphis	Loricariidae	Siluriformes	Teleostei
Gadus	Gadidae	Gadiformes	Teleostei
Hisonotus	Loricariidae	Siluriformes	Teleostei
Brevoortia	Alosidae	Clupeiformes	Teleostei
Somniosus	Somniosidae	Squaliformes	Elasmobranchii
Dunckerocampus	Syngnathidae	Syngnathiformes	Teleostei
Micracanthicus	Loricariidae	Siluriformes	Teleostei
Trachyrincus	Trachyrincidae	Gadiformes	Teleostei
Maxillicosta	Neosebastidae	Perciformes/Scorpaenoidei	Teleostei
Chelmonops	Chaetodontidae	Acanthuriformes	Teleostei
Kali	Chiasmodontidae	Scombriformes	Teleostei
Spatula	Anatidae	Anseriformes	Aves
Xiphocheilus	Labridae	Eupercaria/misc	Teleostei
Aspidophoroides	Agonidae	Perciformes/Cottoidei	Teleostei
Suruga	Gobiidae	Gobiiformes	Teleostei
Neostethus	Phallostethidae	Atheriniformes	Teleostei
Gonostoma	Gonostomatidae	Stomiiformes	Teleostei
Pangasius	Pangasiidae	Siluriformes	Teleostei
Neoconger	Moringuidae	Anguilliformes	Teleostei
Squaloliparis	Liparidae	Perciformes/Cottoidei	Teleostei
Gymnura	Gymnuridae	Myliobatiformes	Elasmobranchii
Phoxocampus	Syngnathidae	Syngnathiformes	Teleostei
Gurgesiella	Gurgesiellidae	Rajiformes	Elasmobranchii
Scopelosaurus	Notosudidae	Aulopiformes	Teleostei
Strangomera	Clupeidae	Clupeiformes	Teleostei
Hemilepidotus	Cottidae	Perciformes/Cottoidei	Teleostei
Uroconger	Congridae	Anguilliformes	Teleostei
Blenniella	Blenniidae	Blenniiformes	Teleostei
Thymallus	Salmonidae	Salmoniformes	Teleostei
Apistoloricaria	Loricariidae	Siluriformes	Teleostei
Panaqolus	Loricariidae	Siluriformes	Teleostei
Archamia	Apogonidae	Kurtiformes	Teleostei
Variabilichromis	Cichlidae	Cichliformes	Teleostei
Percichthys	Percichthyidae	Centrarchiformes	Teleostei
Neomyxine	Myxinidae	Myxiniformes	Myxini
Albatrossia	Macrouridae	Gadiformes	Teleostei
Nanochromis	Cichlidae	Cichliformes	Teleostei
Rondonacara	Cichlidae	Cichliformes	Teleostei
Apodichthys	Pholidae	Perciformes/Zoarcoidei	Teleostei
Cololabis	Scomberesocidae	Beloniformes	Teleostei
Anoplagonus	Agonidae	Perciformes/Cottoidei	Teleostei
Discordipinna	Gobiidae	Gobiiformes	Teleostei
Hoplunnis	Nettastomatidae	Anguilliformes	Teleostei
Neosalangichthys	Salangidae	Osmeriformes	Teleostei
Neoniphon	Holocentridae	Holocentriformes	Teleostei
Dolichopteryx	Opisthoproctidae	Argentiniformes	Teleostei
Eleginops	Eleginopidae	Perciformes/Notothenioidei	Teleostei
Parambassis	Ambassidae	Ovalentaria/misc	Teleostei
Cladorhynchus	Recurvirostridae	Charadriiformes	Aves
Chlorurus	Scaridae	Eupercaria/misc	Teleostei
Amphistichus	Embiotocidae	Ovalentaria/misc	Teleostei
Dolopichthys	Oneirodidae	Lophiiformes	Teleostei
Atherinosoma	Atherinidae	Atheriniformes	Teleostei
Foa	Apogonidae	Kurtiformes	Teleostei
Chaunacops	Chaunacidae	Lophiiformes	Teleostei
Pseudaphritis	Pseudaphritidae	Perciformes/Notothenioidei	Teleostei
Acanthostracion	Ostraciidae	Tetraodontiformes	Teleostei
Altrichthys	Pomacentridae	Ovalentaria/misc	Teleostei
Notoscopelus	Myctophidae	Myctophiformes	Teleostei
Glyphis	Carcharhinidae	Carcharhiniformes	Elasmobranchii
Leptoclinus	Lumpenidae	Perciformes/Zoarcoidei	Teleostei
Rioraja	Arhynchobatidae	Rajiformes	Elasmobranchii
Sauromuraenesox	Muraenesocidae	Anguilliformes	Teleostei
Diancistrus	Dinematichthyidae	Ophidiiformes	Teleostei
Ctenogobiops	Gobiidae	Gobiiformes	Teleostei
Atlantirivulus	Rivulidae	Cyprinodontiformes	Teleostei
Helicophagus	Pangasiidae	Siluriformes	Teleostei
Cetonurus	Macrouridae	Gadiformes	Teleostei
Calamopteryx	Bythitidae	Ophidiiformes	Teleostei
Lestidiops	Lestidiidae	Aulopiformes	Teleostei
Gymneleotris	Gobiidae	Gobiiformes	Teleostei
Paragaleus	Hemigaleidae	Carcharhiniformes	Elasmobranchii
Beringraja	Rajidae	Rajiformes	Elasmobranchii
Haemulon	Haemulidae	Eupercaria/misc	Teleostei
Agonomalus	Agonidae	Perciformes/Cottoidei	Teleostei
Pusa	Phocidae	Carnivora	Mammalia
Zebrasoma	Acanthuridae	Acanthuriformes	Teleostei
Pseudobathylagus	Bathylagidae	Argentiniformes	Teleostei
Cochlearius	Ardeidae	Ciconiiformes	Aves
Scopeloberyx	Melamphaidae	Beryciformes	Teleostei
Ahlia	Ophichthidae	Anguilliformes	Teleostei
Bassozetus	Ophidiidae	Ophidiiformes	Teleostei
Dicentrarchus	Moronidae	Eupercaria/misc	Teleostei
Trisopterus	Gadidae	Gadiformes	Teleostei
Dermatolepis	Epinephelidae	Perciformes/Serranoidei	Teleostei
Aulorhynchus	Aulorhynchidae	Perciformes/Gasterosteoidei	Teleostei
Neoditrema	Embiotocidae	Ovalentaria/misc	Teleostei
Rhadinocentrus	Melanotaeniidae	Atheriniformes	Teleostei
Festucalex	Syngnathidae	Syngnathiformes	Teleostei
Pterygotrigla	Triglidae	Perciformes/Scorpaenoidei	Teleostei
Lucifuga	Bythitidae	Ophidiiformes	Teleostei
Pentaprion	Gerreidae	Eupercaria/misc	Teleostei
Anoxypristis	Pristidae	Rhinopristiformes	Elasmobranchii
Calloplesiops	Plesiopidae	Ovalentaria/misc	Teleostei
Meuschenia	Monacanthidae	Tetraodontiformes	Teleostei
Lipophrys	Blenniidae	Blenniiformes	Teleostei
Hyporthodus	Epinephelidae	Perciformes/Serranoidei	Teleostei
Sudis	Paralepididae	Aulopiformes	Teleostei
Hoplobrotula	Ophidiidae	Ophidiiformes	Teleostei
Exastilithoxus	Loricariidae	Siluriformes	Teleostei
Fibramia	Apogonidae	Kurtiformes	Teleostei
Johnrandallia	Chaetodontidae	Acanthuriformes	Teleostei
Cypselurus	Exocoetidae	Beloniformes	Teleostei
Tursiops	Delphinidae	Cetartiodactyla	Mammalia
Cincelichthys	Cichlidae	Cichliformes	Teleostei
Dolloidraco	Artedidraconidae	Perciformes/Notothenioidei	Teleostei
Aristochromis	Cichlidae	Cichliformes	Teleostei
Clariger	Gobiidae	Gobiiformes	Teleostei
Wuhanlinigobius	Gobiidae	Gobiiformes	Teleostei
Odontostomops	Evermannellidae	Aulopiformes	Teleostei
Lepadogaster	Gobiesocidae	Gobiesociformes	Teleostei
Proterorhinus	Gobiidae	Gobiiformes	Teleostei
Salmo	Salmonidae	Salmoniformes	Teleostei
Raniceps	Ranicipitidae	Gadiformes	Teleostei
Erotelis	Eleotridae	Gobiiformes	Teleostei
Pegasus	Pegasidae	Dactylopteriformes	Teleostei
Cynodonichthys	Rivulidae	Cyprinodontiformes	Teleostei
Bembras	Bembridae	Perciformes/Scorpaenoidei	Teleostei
Diretmus	Diretmidae	Trachichthyiformes	Teleostei
Lasiancistrus	Loricariidae	Siluriformes	Teleostei
Batrachomoeus	Batrachoididae	Batrachoidiformes	Teleostei
Soleichthys	Soleidae	Pleuronectiformes	Teleostei
Reicheltia	Tetraodontidae	Tetraodontiformes	Teleostei
Neophrynichthys	Psychrolutidae	Perciformes/Cottoidei	Teleostei
Plagioscion	Sciaenidae	Eupercaria/misc	Teleostei
Cryptacanthodes	Cryptacanthodidae	Perciformes/Zoarcoidei	Teleostei
Selaroides	Carangidae	Carangiformes	Teleostei
Tetrabrachium	Tetrabrachiidae	Lophiiformes	Teleostei
Hemipsilichthys	Loricariidae	Siluriformes	Teleostei
Argyrops	Sparidae	Eupercaria/misc	Teleostei
Cryodraco	Channichthyidae	Perciformes	Teleostei
Bothrocarina	Zoarcidae	Perciformes/Zoarcoidei	Teleostei
Pseudosimochromis	Cichlidae	Cichliformes	Teleostei
Protonibea	Sciaenidae	Eupercaria/misc	Teleostei
Didogobius	Gobiidae	Gobiiformes	Teleostei
Chilara	Ophidiidae	Ophidiiformes	Teleostei
Sphyraenops	Epigonidae	Acropomatiformes	Teleostei
Xeniamia	Apogonidae	Kurtiformes	Teleostei
Xenurolebias	Rivulidae	Cyprinodontiformes	Teleostei
Paratrygon	Potamotrygonidae	Myliobatiformes	Elasmobranchii
Holocentrus	Holocentridae	Holocentriformes	Teleostei
Spectrolebias	Rivulidae	Cyprinodontiformes	Teleostei
Raneya	Ophidiidae	Ophidiiformes	Teleostei
Macquaria	Percichthyidae	Centrarchiformes	Teleostei
Cyphocottus	Cottidae	Perciformes/Cottoidei	Teleostei
Holohalaelurus	Pentanchidae	Carcharhiniformes	Elasmobranchii
Artedidraco	Artedidraconidae	Perciformes/Notothenioidei	Teleostei
Randallichthys	Lutjanidae	Eupercaria/misc	Teleostei
Evermannella	Evermannellidae	Aulopiformes	Teleostei
Lophiodes	Lophiidae	Lophiiformes	Teleostei
Rimicola	Gobiesocidae	Gobiesociformes	Teleostei
Porophryne	Histiophrynidae	Lophiiformes	Teleostei
Lophodytes	Anatidae	Anseriformes	Aves
Typhliasina	Dinematichthyidae	Ophidiiformes	Teleostei
Lophodolos	Oneirodidae	Lophiiformes	Teleostei
Tuamotuichthys	Bythitidae	Ophidiiformes	Teleostei
Petrochromis	Cichlidae	Cichliformes	Teleostei
Pseudocarcharias	Pseudocarchariidae	Lamniformes	Elasmobranchii
Trachypoma	Anthiadidae	Perciformes/Serranoidei	Teleostei
Satyrichthys	Peristediidae	Perciformes/Scorpaenoidei	Teleostei
Schuettea	Monodactylidae	Eupercaria/misc	Teleostei
Bathyraja	Arhynchobatidae	Rajiformes	Elasmobranchii
Solenostomus	Solenostomidae	Syngnathiformes	Teleostei
Bellator	Triglidae	Perciformes/Scorpaenoidei	Teleostei
Olisthops	Odacidae	Eupercaria/misc	Teleostei
Polyacanthonotus	Notacanthidae	Notacanthiformes	Teleostei
Lepidion	Moridae	Gadiformes	Teleostei
Marosatherina	Telmatherinidae	Atheriniformes	Teleostei
Carlhubbsia	Poeciliidae	Cyprinodontiformes	Teleostei
Rastrelliger	Scombridae	Scombriformes	Teleostei
Protosalanx	Salangidae	Osmeriformes	Teleostei
Anthias	Anthiadidae	Perciformes/Serranoidei	Teleostei
Aspasmichthys	Gobiesocidae	Gobiesociformes	Teleostei
Sparidentex	Sparidae	Eupercaria/misc	Teleostei
Abalistes	Balistidae	Tetraodontiformes	Teleostei
Atherion	Atherionidae	Atheriniformes	Teleostei
Psenopsis	Centrolophidae	Scombriformes	Teleostei
Desmodema	Trachipteridae	Lampriformes	Teleostei
Priolepis	Gobiidae	Gobiiformes	Teleostei
Pachystomias	Stomiidae	Stomiiformes	Teleostei
Akarotaxis	Bathydraconidae	Perciformes/Notothenioidei	Teleostei
Pterocaesio	Caesionidae	Eupercaria/misc	Teleostei
Pomadasys	Haemulidae	Eupercaria/misc	Teleostei
Chimaera	Chimaeridae	Chimaeriformes	Holocephali
Monochirus	Soleidae	Pleuronectiformes	Teleostei
Vanellus	Charadriidae	Charadriiformes	Aves
Bathytyphlops	Ipnopidae	Aulopiformes	Teleostei
Parophrys	Pleuronectidae	Pleuronectiformes	Teleostei
Parexocoetus	Exocoetidae	Beloniformes	Teleostei
Chilorhinus	Chlopsidae	Anguilliformes	Teleostei
Enneapterygius	Tripterygiidae	Blenniiformes	Teleostei
Lycodichthys	Zoarcidae	Perciformes/Zoarcoidei	Teleostei
Platax	Ephippidae	Acanthuriformes	Teleostei
Lyopsetta	Pleuronectidae	Pleuronectiformes	Teleostei
Eucryphycus	Zoarcidae	Perciformes/Zoarcoidei	Teleostei
Threskiornis	Threskiornithidae	Ciconiiformes	Aves
Pseudacanthicus	Loricariidae	Siluriformes	Teleostei
Protogobius	Rhyacichthyidae	Gobiiformes	Teleostei
Pseudobulweria	Procellariidae	Procellariiformes	Aves
Stiphodon	Gobiidae	Gobiiformes	Teleostei
Pagophilus	Phocidae	Carnivora	Mammalia
Graus	Girellidae	Centrarchiformes	Teleostei
Fowleria	Apogonidae	Kurtiformes	Teleostei
Iluocoetes	Zoarcidae	Perciformes/Zoarcoidei	Teleostei
Vimba	Leuciscidae	Cypriniformes	Teleostei
Percilia	Perciliidae	Centrarchiformes	Teleostei
Plegadis	Threskiornithidae	Ciconiiformes	Aves
Lyconus	Lyconidae	Gadiformes	Teleostei
Brachysomophis	Ophichthidae	Anguilliformes	Teleostei
Thysochromis	Cichlidae	Cichliformes	Teleostei
Ectodus	Cichlidae	Cichliformes	Teleostei
Alertichthys	Zanclorhynchidae	Perciformes/Scorpaenoidei	Teleostei
Stenella	Delphinidae	Cetartiodactyla	Mammalia
Itycirrhitus	Cirrhitidae	Centrarchiformes	Teleostei
Dichotomyctere	Tetraodontidae	Tetraodontiformes	Teleostei
Brustiarius	Ariidae	Siluriformes	Teleostei
Cordylancistrus	Loricariidae	Siluriformes	Teleostei
Occidentarius	Ariidae	Siluriformes	Teleostei
Apocryptodon	Oxudercidae	Gobiiformes	Teleostei
Paralithoxus	Loricariidae	Siluriformes	Teleostei
Pachyptila	Procellariidae	Procellariiformes	Aves
Orcinus	Delphinidae	Cetartiodactyla	Mammalia
Accipiter	Accipitridae	Falconiformes	Aves
Rhynchactis	Gigantactinidae	Lophiiformes	Teleostei
Dasycottus	Psychrolutidae	Perciformes/Cottoidei	Teleostei
Lamprologus	Cichlidae	Cichliformes	Teleostei
Albula	Albulidae	Albuliformes	Teleostei
Gadella	Moridae	Gadiformes	Teleostei
Austrolabrus	Labridae	Eupercaria/misc	Teleostei
Ardeola	Ardeidae	Ciconiiformes	Aves
Lycenchelys	Zoarcidae	Perciformes/Zoarcoidei	Teleostei
Latimeria	Latimeriidae	Coelacanthiformes	Coelacanthi
Teixeirichthys	Pomacentridae	Ovalentaria/misc	Teleostei
Cichlasoma	Cichlidae	Cichliformes	Teleostei
Larabicus	Labridae	Eupercaria/misc	Teleostei
Osteomugil	Mugilidae	Mugiliformes	Teleostei
Phthanophaneron	Anomalopidae	Trachichthyiformes	Teleostei
Epactionotus	Loricariidae	Siluriformes	Teleostei
Puffinus	Procellariidae	Procellariiformes	Aves
Gymnammodytes	Ammodytidae	Perciformes/Uranoscopoidei	Teleostei
Kimberleyeleotris	Eleotridae	Gobiiformes	Teleostei
Hirundichthys	Exocoetidae	Beloniformes	Teleostei
Geotria	Geotriidae	Petromyzontiformes	Petromyzonti
Discopyge	Narcinidae	Torpediniformes	Elasmobranchii
Seriolella	Centrolophidae	Scombriformes	Teleostei
Crenidens	Sparidae	Eupercaria/misc	Teleostei
Cepphus	Alcidae	Charadriiformes	Aves
Luciobrotula	Ophidiidae	Ophidiiformes	Teleostei
Biotodoma	Cichlidae	Cichliformes	Teleostei
Ericymba	Leuciscidae	Cypriniformes	Teleostei
Echiophis	Ophichthidae	Anguilliformes	Teleostei
Alcichthys	Cottidae	Perciformes/Cottoidei	Teleostei
Dysomma	Synaphobranchidae	Anguilliformes	Teleostei
Amoya	Gobiidae	Gobiiformes	Teleostei
Phoebastria	Diomedeidae	Procellariiformes	Aves
Gobiomorus	Eleotridae	Gobiiformes	Teleostei
Trematocranus	Cichlidae	Cichliformes	Teleostei
Colistium	Rhombosoleidae	Pleuronectiformes	Teleostei
Xiphasia	Blenniidae	Blenniiformes	Teleostei
Gorgasia	Congridae	Anguilliformes	Teleostei
Chaeturichthys	Gobiidae	Gobiiformes	Teleostei
Phyllophichthus	Ophichthidae	Anguilliformes	Teleostei
Deckertichthys	Gerreidae	Eupercaria/misc	Teleostei
Heterophotus	Stomiidae	Stomiiformes	Teleostei
Busarellus	Accipitridae	Falconiformes	Aves
Heraldia	Syngnathidae	Syngnathiformes	Teleostei
Anarrhichthys	Anarhichadidae	Perciformes/Zoarcoidei	Teleostei
Hemitripterus	Agonidae	Perciformes/Cottoidei	Teleostei
Zoramia	Apogonidae	Kurtiformes	Teleostei
Australoheros	Cichlidae	Cichliformes	Teleostei
Atheresthes	Pleuronectidae	Pleuronectiformes	Teleostei
Acanthodraco	Bathydraconidae	Perciformes/Notothenioidei	Teleostei
Prognichthys	Exocoetidae	Beloniformes	Teleostei
Nettenchelys	Nettastomatidae	Anguilliformes	Teleostei
Astrapogon	Apogonidae	Kurtiformes	Teleostei
Erisphex	Aploactinidae	Perciformes/Scorpaenoidei	Teleostei
Aculeola	Etmopteridae	Squaliformes	Elasmobranchii
Gelochelidon	Laridae	Charadriiformes	Aves
Stiltia	Glareolidae	Charadriiformes	Aves
Squalus	Squalidae	Squaliformes	Elasmobranchii
Xenus	Pyrenulales incertae sedis	Pyrenulales	Eurotiomycetes
Amazonsprattus	Engraulidae	Clupeiformes	Teleostei
Cymatoceps	Sparidae	Eupercaria/misc	Teleostei
Bahaba	Sciaenidae	Eupercaria/misc	Teleostei
Fluvitrygon	Dasyatidae	Myliobatiformes	Elasmobranchii
Scatophagus	Scatophagidae	Acanthuriformes	Teleostei
Tetronarce	Torpedinidae	Torpediniformes	Elasmobranchii
Ophiclinus	Clinidae	Blenniiformes	Teleostei
Scylliogaleus	Triakidae	Carcharhiniformes	Elasmobranchii
Eudontomyzon	Petromyzontidae	Petromyzontiformes	Petromyzonti
Krefftichthys	Myctophidae	Myctophiformes	Teleostei
Sio	Melamphaidae	Beryciformes	Teleostei
Neopagetopsis	Channichthyidae	Perciformes/Notothenioidei	Teleostei
Serranus	Serranidae	Perciformes/Serranoidei	Teleostei
Persparsia	Platytroctidae	Alepocephaliformes	Teleostei
Scorpaenichthys	Jordaniidae	Perciformes/Cottoidei	Teleostei
Boesemania	Sciaenidae	Eupercaria/misc	Teleostei
Trichromis	Cichlidae	Cichliformes	Teleostei
Elates	Platycephalidae	Perciformes/Scorpaenoidei	Teleostei
Cheilopogon	Exocoetidae	Beloniformes	Teleostei
Kronoheros	Cichlidae	Cichliformes	Teleostei
Lonchopisthus	Opistognathidae	Ovalentaria/misc	Teleostei
Trichodon	Trichodontidae	Perciformes/Uranoscopoidei	Teleostei
Selar	Carangidae	Carangiformes	Teleostei
Chaenopsis	Chaenopsidae	Blenniiformes	Teleostei
Dactyloscopus	Dactyloscopidae	Blenniiformes	Teleostei
Alepisaurus	Alepisauridae	Aulopiformes	Teleostei
Heteropriacanthus	Priacanthidae	Eupercaria/misc	Teleostei
Nomeus	Nomeidae	Scombriformes	Teleostei
Rathbunella	Bathymasteridae	Perciformes/Zoarcoidei	Teleostei
Taenioides	Gobiidae	Gobiiformes	Teleostei
Sparus	Sparidae	Eupercaria/misc	Teleostei
Histiobranchus	Synaphobranchidae	Anguilliformes	Teleostei
Carapus	Carapidae	Ophidiiformes	Teleostei
Dotalabrus	Labridae	Eupercaria/misc	Teleostei
Stegostoma	Stegostomatidae	Orectolobiformes	Elasmobranchii
Renova	Rivulidae	Cyprinodontiformes	Teleostei
Porogobius	Gobiidae	Gobiiformes	Teleostei
Podiceps	Podicipedidae	Podicipediformes	Aves
Pseudochromis	Pseudochromidae	Ovalentaria/misc	Teleostei
Monocentris	Monocentridae	Trachichthyiformes	Teleostei
Oligoplites	Carangidae	Carangiformes	Teleostei
Alectrias	Stichaeidae	Perciformes/Zoarcoidei	Teleostei
Eumesogrammus	Stichaeidae	Perciformes/Zoarcoidei	Teleostei
Etmopterus	Etmopteridae	Squaliformes	Elasmobranchii
Tridentiger	Gobiidae	Gobiiformes	Teleostei
Iracundus	Scorpaenidae	Perciformes/Scorpaenoidei	Teleostei
Rhynchobatus	Rhinidae	Rhinopristiformes	Elasmobranchii
Loricaria	Loricariidae	Siluriformes	Teleostei
Acanthochaenus	Stephanoberycidae	Beryciformes	Teleostei
Maculabatis	Dasyatidae	Myliobatiformes	Elasmobranchii
Bulweria	Procellariidae	Procellariiformes	Aves
Eopsetta	Pleuronectidae	Pleuronectiformes	Teleostei
Limosa	Scolopacidae	Charadriiformes	Aves
Neomyxus	Mugilidae	Mugiliformes	Teleostei
Aviceda	Accipitridae	Falconiformes	Aves
Trichocottus	Cottidae	Perciformes/Cottoidei	Teleostei
Gasterochisma	Scombridae	Scombriformes	Teleostei
Ceratoscopelus	Myctophidae	Myctophiformes	Teleostei
Terathopius	Accipitridae	Falconiformes	Aves
Atule	Carangidae	Carangiformes	Teleostei
Kogia	Kogiidae	Cetartiodactyla	Mammalia
Pseudophoxinus	Leuciscidae	Cypriniformes	Teleostei
Chaetodontoplus	Pomacanthidae	Acanthuriformes	Teleostei
Carangoides	Carangidae	Carangiformes	Teleostei
Siphonogobius	Gobiidae	Gobiiformes	Teleostei
Lachnolaimus	Labridae	Eupercaria/misc	Teleostei
Larus	Laridae	Charadriiformes	Aves
Agonopsis	Agonidae	Perciformes/Cottoidei	Teleostei
Physiculus	Moridae	Gadiformes	Teleostei
Yirrkala	Ophichthidae	Anguilliformes	Teleostei
Luciosudis	Notosudidae	Aulopiformes	Teleostei
Ethmalosa	Dorosomatidae	Clupeiformes	Teleostei
Seriolina	Carangidae	Carangiformes	Teleostei
Channa	Channidae	Anabantiformes	Teleostei
Halieutaea	Ogcocephalidae	Lophiiformes	Teleostei
Onuxodon	Carapidae	Ophidiiformes	Teleostei
Penopus	Ophidiidae	Ophidiiformes	Teleostei
Parasicydium	Gobiidae	Gobiiformes	Teleostei
Ateleopus	Ateleopodidae	Ateleopodiformes	Teleostei
Bullisichthys	Serranidae	Perciformes/Serranoidei	Teleostei
Callogobius	Gobiidae	Gobiiformes	Teleostei
Rastrinus	Cottidae	Perciformes/Cottoidei	Teleostei
Sotalia	Delphinidae	Cetartiodactyla	Mammalia
Dascyllus	Pomacentridae	Ovalentaria/misc	Teleostei
Megalocottus	Cottidae	Perciformes/Cottoidei	Teleostei
Orthopristis	Haemulidae	Eupercaria/misc	Teleostei
Labrisomus	Labrisomidae	Blenniiformes	Teleostei
Oedalechilus	Mugilidae	Mugiliformes	Teleostei
Flexor	Gobiesocidae	Gobiesociformes	Teleostei
Avocettina	Nemichthyidae	Anguilliformes	Teleostei
Eulophias	Eulophiidae	Perciformes/Zoarcoidei	Teleostei
Aprognathodon	Ophichthidae	Anguilliformes	Teleostei
Parotocinclus	Loricariidae	Siluriformes	Teleostei
Laiopteryx	Citharidae	Pleuronectiformes	Teleostei
Limnichthys	Creediidae	Acropomatiformes	Teleostei
Glossogobius	Gobiidae	Gobiiformes	Teleostei
Chrysiptera	Pomacentridae	Ovalentaria/misc	Teleostei
Gymnoscopelus	Myctophidae	Myctophiformes	Teleostei
Potamarius	Ariidae	Siluriformes	Teleostei
Gillellus	Dactyloscopidae	Blenniiformes	Teleostei
Poromitra	Melamphaidae	Beryciformes	Teleostei
Salvethymus	Salmonidae	Salmoniformes	Teleostei
Pteroscion	Sciaenidae	Eupercaria/misc	Teleostei
Cookeolus	Priacanthidae	Eupercaria/misc	Teleostei
Lycogrammoides	Zoarcidae	Perciformes/Zoarcoidei	Teleostei
Hemisalanx	Salangidae	Osmeriformes	Teleostei
Bentartia	Zoarcidae	Perciformes/Zoarcoidei	Teleostei
Pelmatolapia	Cichlidae	Cichliformes	Teleostei
Laemonema	Moridae	Gadiformes	Teleostei
Terranatos	Rivulidae	Cyprinodontiformes	Teleostei
Ruscarius	Cottidae	Perciformes/Cottoidei	Teleostei
Bathysaurus	Bathysauridae	Aulopiformes	Teleostei
Rhinosardinia	Dorosomatidae	Clupeiformes	Teleostei
Diodon	Diodontidae	Tetraodontiformes	Teleostei
Chromidotilapia	Cichlidae	Cichliformes	Teleostei
Elanoides	Accipitridae	Falconiformes	Aves
Rhinomuraena	Muraenidae	Anguilliformes	Teleostei
Gigantactis	Gigantactinidae	Lophiiformes	Teleostei
Zabidius	Ephippidae	Acanthuriformes	Teleostei
Eurycheilichthys	Loricariidae	Siluriformes	Teleostei
Acanthoplesiops	Plesiopidae	Ovalentaria/misc	Teleostei
Gobioclinus	Labrisomidae	Blenniiformes	Teleostei
Cochlefelis	Ariidae	Siluriformes	Teleostei
Haletta	Odacidae	Eupercaria/misc	Teleostei
Oxycheilinus	Labridae	Eupercaria/misc	Teleostei
Astrabe	Gobiidae	Gobiiformes	Teleostei
Peprilus	Stromateidae	Scombriformes	Teleostei
Gymnomuraena	Muraenidae	Anguilliformes	Teleostei
Grammatotria	Cichlidae	Cichliformes	Teleostei
Archosargus	Sparidae	Eupercaria/misc	Teleostei
Pseudosynanceia	Synanceiidae	Perciformes/Scorpaenoidei	Teleostei
Thaumatichthys	Thaumatichthyidae	Lophiiformes	Teleostei
Mordacia	Mordaciidae	Petromyzontiformes	Petromyzonti
Hoplarchus	Cichlidae	Cichliformes	Teleostei
Menticirrhus	Sciaenidae	Eupercaria/misc	Teleostei
Dissostichus	Nototheniidae	Perciformes/Notothenioidei	Teleostei
Toxotes	Toxotidae	Carangaria/misc	Teleostei
Zeus	Zeidae	Zeiformes	Teleostei
Chrionema	Bembropidae	Perciformes/Bembropoidei	Teleostei
Centropristis	Serranidae	Perciformes/Serranoidei	Teleostei
Microthrissa	Dorosomatidae	Clupeiformes	Teleostei
Stethojulis	Labridae	Eupercaria/misc	Teleostei
Dipterygonotus	Caesionidae	Eupercaria/misc	Teleostei
Chaenogaleus	Hemigaleidae	Carcharhiniformes	Elasmobranchii
Diademichthys	Gobiesocidae	Gobiesociformes	Teleostei
Ethmidium	Clupeidae	Clupeiformes	Teleostei
Macruronus	Macruronidae	Gadiformes	Teleostei
Paraluteres	Monacanthidae	Tetraodontiformes	Teleostei
Parviparma	Butidae	Gobiiformes	Teleostei
Bolbometopon	Scaridae	Eupercaria/misc	Teleostei
Pterotolithus	Sciaenidae	Eupercaria/misc	Teleostei
Limnodromus	Scolopacidae	Charadriiformes	Aves
Mora	Moridae	Gadiformes	Teleostei
Psammoperca	Latidae	Carangaria/misc	Teleostei
Afurcagobius	Gobiidae	Gobiiformes	Teleostei
Oxycirrhites	Cirrhitidae	Centrarchiformes	Teleostei
Cymbacephalus	Platycephalidae	Perciformes/Scorpaenoidei	Teleostei
Avalithoxus	Loricariidae	Siluriformes	Teleostei
Anacanthus	Monacanthidae	Tetraodontiformes	Teleostei
Zapogon	Apogonidae	Kurtiformes	Teleostei
Ophiodon	Hexagrammidae	Perciformes/Cottoidei	Teleostei
Bathysphyraenops	Howellidae	Acropomatiformes	Teleostei
Aplodactylus	Aplodactylidae	Centrarchiformes	Teleostei
Acanthopsetta	Pleuronectidae	Pleuronectiformes	Teleostei
Paroncheilus	Apogonidae	Kurtiformes	Teleostei
Obliquogobius	Gobiidae	Gobiiformes	Teleostei
Myctophum	Myctophidae	Myctophiformes	Teleostei
Astroscopus	Uranoscopidae	Perciformes/Uranoscopoidei	Teleostei
Howella	Howellidae	Acropomatiformes	Teleostei
Heteroscarus	Odacidae	Eupercaria/misc	Teleostei
Parachondrostoma	Leuciscidae	Cypriniformes	Teleostei
Pteronotropis	Leuciscidae	Cypriniformes	Teleostei
Algansea	Leuciscidae	Cypriniformes	Teleostei
Austrolycus	Zoarcidae	Perciformes/Zoarcoidei	Teleostei
Allocareproctus	Liparidae	Perciformes/Cottoidei	Teleostei
Alburnus	Leuciscidae	Cypriniformes	Teleostei
Filicampus	Syngnathidae	Syngnathiformes	Teleostei
Sagamia	Gobiidae	Gobiiformes	Teleostei
Scolopsis	Nemipteridae	Eupercaria/misc	Teleostei
Alepes	Carangidae	Carangiformes	Teleostei
Leuresthes	Atherinopsidae	Atheriniformes	Teleostei
Cirrhimuraena	Ophichthidae	Anguilliformes	Teleostei
Hemiancistrus	Loricariidae	Siluriformes	Teleostei
Filimanus	Polynemidae	Carangaria/misc	Teleostei
Rhacochilus	Embiotocidae	Ovalentaria/misc	Teleostei
Centrogenys	Centrogenyidae	Eupercaria/misc	Teleostei
Eremichthys	Leuciscidae	Cypriniformes	Teleostei
Schultzidia	Ophichthidae	Anguilliformes	Teleostei
Chalixodytes	Creediidae	Acropomatiformes	Teleostei
Hypsolebias	Rivulidae	Cyprinodontiformes	Teleostei
Buteogallus	Accipitridae	Falconiformes	Aves
Copadichromis	Cichlidae	Cichliformes	Teleostei
Stokellia	Retropinnidae	Osmeriformes	Teleostei
Squalius	Leuciscidae	Cypriniformes	Teleostei
Rollandia	Podicipedidae	Podicipediformes	Aves
Chilochromis	Cichlidae	Cichliformes	Teleostei
Pycnochromis	Pomacentridae	Ovalentaria/misc	Teleostei
Furcina	Cottidae	Perciformes/Cottoidei	Teleostei
Aplochiton	Galaxiidae	Galaxiiformes	Teleostei
Hydrobates	Hydrobatidae	Procellariiformes	Aves
Aspidontus	Blenniidae	Blenniiformes	Teleostei
Pachypops	Sciaenidae	Eupercaria/misc	Teleostei
Diomedea	Diomedeidae	Procellariiformes	Aves
Ophisurus	Ophichthidae	Anguilliformes	Teleostei
Furgaleus	Triakidae	Carcharhiniformes	Elasmobranchii
Champsocephalus	Channichthyidae	Perciformes/Notothenioidei	Teleostei
Bujurquina	Cichlidae	Cichliformes	Teleostei
Coloconger	Colocongridae	Anguilliformes	Teleostei
Mylopharodon	Leuciscidae	Cypriniformes	Teleostei
Yuriria	Leuciscidae	Cypriniformes	Teleostei
Bathymyrus	Congridae	Anguilliformes	Teleostei
Diastobranchus	Synaphobranchidae	Anguilliformes	Teleostei
Hucho	Salmonidae	Salmoniformes	Teleostei
Lipocheilus	Lutjanidae	Eupercaria/misc	Teleostei
Corymbophanes	Loricariidae	Siluriformes	Teleostei
Eviota	Gobiidae	Gobiiformes	Teleostei
Barchatus	Batrachoididae	Batrachoidiformes	Teleostei
Gymnotocinclus	Loricariidae	Siluriformes	Teleostei
Solivomer	Neoscopelidae	Myctophiformes	Teleostei
Lampris	Lampridae	Lampriformes	Teleostei
Epigonus	Epigonidae	Acropomatiformes	Teleostei
Freemanichthys	Agonidae	Perciformes/Cottoidei	Teleostei
Pseudolithoxus	Loricariidae	Siluriformes	Teleostei
Pandaka	Gobiidae	Gobiiformes	Teleostei
Ptilichthys	Ptilichthyidae	Perciformes/Zoarcoidei	Teleostei
Choeroichthys	Syngnathidae	Syngnathiformes	Teleostei
Sturisomatichthys	Loricariidae	Siluriformes	Teleostei
Otolithoides	Sciaenidae	Eupercaria/misc	Teleostei
Sarda	Scombridae	Scombriformes	Teleostei
Microlipophrys	Blenniidae	Blenniiformes	Teleostei
Notocirrhitus	Cirrhitidae	Centrarchiformes	Teleostei
Pterois	Scorpaenidae	Perciformes/Scorpaenoidei	Teleostei
Sternoptyx	Sternoptychidae	Stomiiformes	Teleostei
Scomberoides	Carangidae	Carangiformes	Teleostei
Metelectrona	Myctophidae	Myctophiformes	Teleostei
Chaunax	Chaunacidae	Lophiiformes	Teleostei
Maylandia	Cichlidae	Cichliformes	Teleostei
Lampadena	Myctophidae	Myctophiformes	Teleostei
Mayaheros	Cichlidae	Cichliformes	Teleostei
Gonichthys	Myctophidae	Myctophiformes	Teleostei
Gymnosarda	Scombridae	Scombriformes	Teleostei
Pempheris	Pempheridae	Acropomatiformes	Teleostei
Hyperlophus	Clupeidae	Clupeiformes	Teleostei
Gobiopterus	Gobiidae	Gobiiformes	Teleostei
Stathmonotus	Chaenopsidae	Blenniiformes	Teleostei
Acanthistius	Anthiadidae	Perciformes/Serranoidei	Teleostei
Ataxolepis	Cetomimidae	Beryciformes	Teleostei
Rhodymenichthys	Pholidae	Perciformes/Zoarcoidei	Teleostei
Vincentia	Apogonidae	Kurtiformes	Teleostei
Pteragogus	Labridae	Eupercaria/misc	Teleostei
Neoclinus	Chaenopsidae	Blenniiformes	Teleostei
Acentronura	Syngnathidae	Syngnathiformes	Teleostei
Austrobatrachus	Batrachoididae	Batrachoidiformes	Teleostei
Sillaginodes	Sillaginidae	Eupercaria/misc	Teleostei
Anser	Anatidae	Anseriformes	Aves
Scomberesox	Scomberesocidae	Beloniformes	Teleostei
Gobiocichla	Cichlidae	Cichliformes	Teleostei
Rineloricaria	Loricariidae	Siluriformes	Teleostei
Feroxodon	Tetraodontidae	Tetraodontiformes	Teleostei
Leptoancistrus	Loricariidae	Siluriformes	Teleostei
Pristipomoides	Lutjanidae	Eupercaria/misc	Teleostei
Hymenogadus	Macrouridae	Gadiformes	Teleostei
Paragalaxias	Galaxiidae	Galaxiiformes	Teleostei
Trichopsetta	Bothidae	Pleuronectiformes	Teleostei
Eretmodus	Cichlidae	Cichliformes	Teleostei
Pelotretis	Rhombosoleidae	Pleuronectiformes	Teleostei
Protomelas	Cichlidae	Cichliformes	Teleostei
Pelecanus	Pelecanidae	Pelecaniformes	Aves
Parancistrus	Loricariidae	Siluriformes	Teleostei
Aporops	Grammistidae	Perciformes/Serranoidei	Teleostei
Apsilus	Lutjanidae	Eupercaria/misc	Teleostei
Bartramia	Bartramiaceae	Bryales	Bryopsida
Parapercis	Pinguipedidae	Perciformes/Uranoscopoidei	Teleostei
Lotella	Moridae	Gadiformes	Teleostei
Acyrtops	Gobiesocidae	Gobiesociformes	Teleostei
Glossanodon	Argentinidae	Argentiniformes	Teleostei
Ucla	Tripterygiidae	Blenniiformes	Teleostei
Epibulus	Labridae	Eupercaria/misc	Teleostei
Anas	Anatidae	Anseriformes	Aves
Pantolabus	Carangidae	Carangiformes	Teleostei
Bathyclupea	Bathyclupeidae	Acropomatiformes	Teleostei
Balaenoptera	Balaenopteridae	Cetartiodactyla	Mammalia
Clangula	Anatidae	Anseriformes	Aves
Synthliboramphus	Alcidae	Charadriiformes	Aves
Melanostomias	Stomiidae	Stomiiformes	Teleostei
Gnathophis	Congridae	Anguilliformes	Teleostei
Scartichthys	Blenniidae	Blenniiformes	Teleostei
Rhinopias	Scorpaenidae	Perciformes/Scorpaenoidei	Teleostei
Dinolestes	Dinolestidae	Acropomatiformes	Teleostei
Lampanyctodes	Myctophidae	Myctophiformes	Teleostei
Stenatherina	Atherinidae	Atheriniformes	Teleostei
Opsopoeodus	Leuciscidae	Cypriniformes	Teleostei
Monomitopus	Ophidiidae	Ophidiiformes	Teleostei
Carangichthys	Carangidae	Carangiformes	Teleostei
Caquetaia	Cichlidae	Cichliformes	Teleostei
Polylepion	Labridae	Eupercaria/misc	Teleostei
Rogadius	Platycephalidae	Perciformes/Scorpaenoidei	Teleostei
Gyps	Accipitridae	Falconiformes	Aves
Lepturacanthus	Trichiuridae	Scombriformes	Teleostei
Bassanago	Congridae	Anguilliformes	Teleostei
Aztecula	Leuciscidae	Cypriniformes	Teleostei
Cataetyx	Bythitidae	Ophidiiformes	Teleostei
Pteraclis	Bramidae	Scombriformes	Teleostei
Pastinachus	Dasyatidae	Myliobatiformes	Elasmobranchii
Sladenia	Lophiidae	Lophiiformes	Teleostei
Gymnachirus	Achiridae	Pleuronectiformes	Teleostei
Lamnostoma	Ophichthidae	Anguilliformes	Teleostei
Takifugu	Tetraodontidae	Tetraodontiformes	Teleostei
Ambassis	Ambassidae	Ovalentaria/misc	Teleostei
Callochromis	Cichlidae	Cichliformes	Teleostei
Otopharynx	Cichlidae	Cichliformes	Teleostei
Ancistomus	Loricariidae	Siluriformes	Teleostei
Pseudocheilinus	Labridae	Eupercaria/misc	Teleostei
Myoglanis	Heptapteridae	Siluriformes	Teleostei
Leptoichthys	Syngnathidae	Syngnathiformes	Teleostei
Parablennius	Blenniidae	Blenniiformes	Teleostei
Neoharriotta	Rhinochimaeridae	Chimaeriformes	Holocephali
Agonus	Agonidae	Perciformes/Cottoidei	Teleostei
Heniochus	Chaetodontidae	Acanthuriformes	Teleostei
Uropterygius	Muraenidae	Anguilliformes	Teleostei
Eridacnis	Proscylliidae	Carcharhiniformes	Elasmobranchii
Ammotretis	Rhombosoleidae	Pleuronectiformes	Teleostei
Emblemariopsis	Chaenopsidae	Blenniiformes	Teleostei
Plagiotremus	Blenniidae	Blenniiformes	Teleostei
Micromoema	Rivulidae	Cyprinodontiformes	Teleostei
Lymnocryptes	Scolopacidae	Charadriiformes	Aves
Bostrychus	Butidae	Gobiiformes	Teleostei
Anarchopterus	Syngnathidae	Syngnathiformes	Teleostei
Hydroprogne	Laridae	Charadriiformes	Aves
Aspasmogaster	Gobiesocidae	Gobiesociformes	Teleostei
Neoscopelus	Neoscopelidae	Myctophiformes	Teleostei
Bathylagus	Bathylagidae	Argentiniformes	Teleostei
Caprodon	Anthiadidae	Perciformes/Serranoidei	Teleostei
Paranotothenia	Nototheniidae	Perciformes/Notothenioidei	Teleostei
Rouleina	Alepocephalidae	Alepocephaliformes	Teleostei
Hypleurochilus	Blenniidae	Blenniiformes	Teleostei
Eleutheronema	Polynemidae	Carangaria/misc	Teleostei
Paulasquama	Loricariidae	Siluriformes	Teleostei
Beryx	Berycidae	Beryciformes	Teleostei
Barbantus	Platytroctidae	Alepocephaliformes	Teleostei
Seleniolycus	Zoarcidae	Perciformes/Zoarcoidei	Teleostei
Mullus	Mullidae	Mulliformes	Teleostei
Genypterus	Ophidiidae	Ophidiiformes	Teleostei
Pontinus	Scorpaenidae	Perciformes/Scorpaenoidei	Teleostei
Dolichancistrus	Loricariidae	Siluriformes	Teleostei
Lucania	Fundulidae	Cyprinodontiformes	Teleostei
Thyrsites	Gempylidae	Scombriformes	Teleostei
Otocinclus	Loricariidae	Siluriformes	Teleostei
Platichthys	Pleuronectidae	Pleuronectiformes	Teleostei
Pungitius	Gasterosteidae	Perciformes/Gasterosteoidei	Teleostei
Wattsia	Lethrinidae	Eupercaria/misc	Teleostei
Diapterus	Gerreidae	Eupercaria/misc	Teleostei
Hemigobius	Gobiidae	Gobiiformes	Teleostei
Brosmophyciops	Bythitidae	Ophidiiformes	Teleostei
Micrometrus	Embiotocidae	Ovalentaria/misc	Teleostei
Dysommina	Synaphobranchidae	Anguilliformes	Teleostei
Gilbertidia	Psychrolutidae	Perciformes/Cottoidei	Teleostei
Histiodraco	Artedidraconidae	Perciformes/Notothenioidei	Teleostei
Indonotothenia	Nototheniidae	Perciformes/Notothenioidei	Teleostei
Pygoplites	Pomacanthidae	Acanthuriformes	Teleostei
Maskaheros	Cichlidae	Cichliformes	Teleostei
Parupeneus	Mullidae	Mulliformes	Teleostei
Ophioblennius	Blenniidae	Blenniiformes	Teleostei
Myrophis	Ophichthidae	Anguilliformes	Teleostei
Pseudophallus	Syngnathidae	Syngnathiformes	Teleostei
Larimus	Sciaenidae	Eupercaria/misc	Teleostei
Cereopsis	Anatidae	Anseriformes	Aves
Pristigenys	Priacanthidae	Eupercaria/misc	Teleostei
Sillaginops	Sillaginidae	Eupercaria/misc	Teleostei
Leucopsarion	Gobiidae	Gobiiformes	Teleostei
Iso	Isonidae	Atheriniformes	Teleostei
Tylerius	Tetraodontidae	Tetraodontiformes	Teleostei
Microdesmus	Microdesmidae	Gobiiformes	Teleostei
Paraconger	Congridae	Anguilliformes	Teleostei
Paretroplus	Cichlidae	Cichliformes	Teleostei
Xiphophorus	Poeciliidae	Cyprinodontiformes	Teleostei
Danaphos	Sternoptychidae	Stomiiformes	Teleostei
Proscyllium	Proscylliidae	Carcharhiniformes	Elasmobranchii
Figaro	Pentanchidae	Carcharhiniformes	Elasmobranchii
Trixiphichthys	Triacanthidae	Tetraodontiformes	Teleostei
Lagiacrusichthys	Scopelarchidae	Aulopiformes	Teleostei
Rubicundus	Myxinidae	Myxiniformes	Myxini
Photostylus	Alepocephalidae	Alepocephaliformes	Teleostei
Tasmanogobius	Gobiidae	Gobiiformes	Teleostei
Parequula	Gerreidae	Eupercaria/misc	Teleostei
Cocotropus	Aploactinidae	Perciformes/Scorpaenoidei	Teleostei
Dinoperca	Dinopercidae	Eupercaria/misc	Teleostei
Coptodon	Cichlidae	Cichliformes	Teleostei
Buteo	Accipitridae	Falconiformes	Aves
Megupsilon	Cyprinodontidae	Cyprinodontiformes	Teleostei
Tahuantinsuyoa	Cichlidae	Cichliformes	Teleostei
Cybiosarda	Scombridae	Scombriformes	Teleostei
Nematalosa	Dorosomatidae	Clupeiformes	Teleostei
Terelabrus	Labridae	Eupercaria/misc	Teleostei
Malacocephalus	Macrouridae	Gadiformes	Teleostei
Prionodraco	Bathydraconidae	Perciformes/Notothenioidei	Teleostei
Boridia	Haemulidae	Eupercaria/misc	Teleostei
Scolichthys	Poeciliidae	Cyprinodontiformes	Teleostei
Auriglobus	Tetraodontidae	Tetraodontiformes	Teleostei
Torquigener	Tetraodontidae	Tetraodontiformes	Teleostei
Cotylopus	Gobiidae	Gobiiformes	Teleostei
Metaloricaria	Loricariidae	Siluriformes	Teleostei
Cynotilapia	Cichlidae	Cichliformes	Teleostei
Otolithes	Sciaenidae	Eupercaria/misc	Teleostei
Opisthocentrus	Opisthocentridae	Perciformes/Zoarcoidei	Teleostei
Potamothrissa	Dorosomatidae	Clupeiformes	Teleostei
Scalicus	Peristediidae	Perciformes/Scorpaenoidei	Teleostei
Thysanactis	Stomiidae	Stomiiformes	Teleostei
Xenomedea	Labrisomidae	Blenniiformes	Teleostei
Zenopsis	Zeidae	Zeiformes	Teleostei
Acanthaphritis	Hemerocoetidae	Acropomatiformes	Teleostei
Pseudoxiphophorus	Poeciliidae	Cyprinodontiformes	Teleostei
Symphysanodon	Symphysanodontidae	Acropomatiformes	Teleostei
Gladioglanis	Heptapteridae	Siluriformes	Teleostei
Brosmophycis	Bythitidae	Ophidiiformes	Teleostei
Malacanthus	Malacanthidae	Eupercaria/misc	Teleostei
Dagetichthys	Soleidae	Pleuronectiformes	Teleostei
Hoplosebastes	Scorpaenidae	Perciformes/Scorpaenoidei	Teleostei
Pluvialis	Charadriidae	Charadriiformes	Aves
Pterogobius	Gobiidae	Gobiiformes	Teleostei
Fregetta	Hydrobatidae	Procellariiformes	Aves
Chirostomias	Stomiidae	Stomiiformes	Teleostei
Etrumeus	Dussumieriidae	Clupeiformes	Teleostei
Scopelogadus	Melamphaidae	Beryciformes	Teleostei
Cryptancistrus	Loricariidae	Siluriformes	Teleostei
Bathyphylax	Triacanthodidae	Tetraodontiformes	Teleostei
Hybopsis	Leuciscidae	Cypriniformes	Teleostei
Brachionichthys	Brachionichthyidae	Lophiiformes	Teleostei
Echelus	Ophichthidae	Anguilliformes	Teleostei
Stellifer	Sciaenidae	Eupercaria/misc	Teleostei
Narke	Narkidae	Torpediniformes	Elasmobranchii
Gobionellus	Gobiidae	Gobiiformes	Teleostei
Jabarichromis	Cichlidae	Cichliformes	Teleostei
Ventichthys	Ophidiidae	Ophidiiformes	Teleostei
Acanthurus	Acanthuridae	Acanthuriformes	Teleostei
Belonepterygion	Plesiopidae	Ovalentaria/misc	Teleostei
Nedystoma	Ariidae	Siluriformes	Teleostei
Anampses	Labridae	Eupercaria/misc	Teleostei
Pleuragramma	Nototheniidae	Perciformes/Notothenioidei	Teleostei
Lepidophanes	Myctophidae	Myctophiformes	Teleostei
Congochromis	Cichlidae	Cichliformes	Teleostei
Tringa	Scolopacidae	Charadriiformes	Aves
Roa	Chaetodontidae	Acanthuriformes	Teleostei
Alopias	Alopiidae	Lamniformes	Elasmobranchii
Fusigobius	Gobiidae	Gobiiformes	Teleostei
Rhabdamia	Apogonidae	Kurtiformes	Teleostei
Metavelifer	Veliferidae	Lampriformes	Teleostei
Genyochromis	Cichlidae	Cichliformes	Teleostei
Phocoena	Phocoenidae	Cetartiodactyla	Mammalia
Bathophilus	Stomiidae	Stomiiformes	Teleostei
Enchelycore	Muraenidae	Anguilliformes	Teleostei
Deania	Centrophoridae	Squaliformes	Elasmobranchii
Leuroglossus	Bathylagidae	Argentiniformes	Teleostei
Thyrsitoides	Gempylidae	Scombriformes	Teleostei
Leptobrama	Leptobramidae	Carangaria/misc	Teleostei
Medialuna	Scorpididae	Centrarchiformes	Teleostei
Halosaurus	Halosauridae	Notacanthiformes	Teleostei
Rypticus	Grammistidae	Perciformes/Serranoidei	Teleostei
Sardina	Alosidae	Clupeiformes	Teleostei
Andinoacara	Cichlidae	Cichliformes	Teleostei
Lithogenes	Loricariidae	Siluriformes	Teleostei
Opostomias	Stomiidae	Stomiiformes	Teleostei
Coelorinchus	Macrouridae	Gadiformes	Teleostei
Stemonosudis	Paralepididae	Aulopiformes	Teleostei
Pictilabrus	Labridae	Eupercaria/misc	Teleostei
Pygoscelis	Spheniscidae	Sphenisciformes	Aves
Labichthys	Nemichthyidae	Anguilliformes	Teleostei
Banjos	Banjosidae	Acropomatiformes	Teleostei
Salaria	Blenniidae	Blenniiformes	Teleostei
Ophiocara	Butidae	Gobiiformes	Teleostei
Rhabdosargus	Sparidae	Eupercaria/misc	Teleostei
Allocyttus	Oreosomatidae	Zeiformes	Teleostei
Mecaenichthys	Pomacentridae	Ovalentaria/misc	Teleostei
Polyamblyodon	Sparidae	Eupercaria/misc	Teleostei
Gymnocranius	Lethrinidae	Eupercaria/misc	Teleostei
Leptolucania	Fundulidae	Cyprinodontiformes	Teleostei
Dexillus	Soleidae	Pleuronectiformes	Teleostei
Peponocephala	Delphinidae	Cetartiodactyla	Mammalia
Lopholiparis	Liparidae	Perciformes/Cottoidei	Teleostei
Pseudotriacanthus	Triacanthidae	Tetraodontiformes	Teleostei
Brachyramphus	Alcidae	Charadriiformes	Aves
Kanekonia	Aploactinidae	Perciformes/Scorpaenoidei	Teleostei
Omobranchus	Blenniidae	Blenniiformes	Teleostei
Elassodiscus	Liparidae	Perciformes/Cottoidei	Teleostei
Leucopleurus	Delphinidae	Cetartiodactyla	Mammalia
Phreatobius	Phreatobiidae	Siluriformes	Teleostei
Opisthonema	Dorosomatidae	Clupeiformes	Teleostei
Scolopax	Scolopacidae	Charadriiformes	Aves
Lethops	Gobiidae	Gobiiformes	Teleostei
Sicamugil	Mugilidae	Mugiliformes	Teleostei
Crystallichthys	Liparidae	Perciformes/Cottoidei	Teleostei
Salvelinus	Salmonidae	Salmoniformes	Teleostei
Centroberyx	Berycidae	Beryciformes	Teleostei
Hypopterus	Latidae	Carangaria/misc	Teleostei
Siganus	Siganidae	Acanthuriformes	Teleostei
Megatrygon	Dasyatidae	Myliobatiformes	Elasmobranchii
Barbuligobius	Gobiidae	Gobiiformes	Teleostei
Lyconema	Zoarcidae	Perciformes/Zoarcoidei	Teleostei
Kelloggella	Gobiidae	Gobiiformes	Teleostei
Peristedion	Peristediidae	Perciformes/Scorpaenoidei	Teleostei
Butastur	Accipitridae	Falconiformes	Aves
Monacoa	Opisthoproctidae	Argentiniformes	Teleostei
Hemilutjanus	Malakichthyidae	Acropomatiformes	Teleostei
Ellochelon	Mugilidae	Mugiliformes	Teleostei
Macrodon	Sciaenidae	Eupercaria/misc	Teleostei
Euthynnus	Scombridae	Scombriformes	Teleostei
Acromycter	Congridae	Anguilliformes	Teleostei
Llanolebias	Rivulidae	Cyprinodontiformes	Teleostei
Gymnoclinus	Stichaeidae	Perciformes/Zoarcoidei	Teleostei
Croilia	Gobiidae	Gobiiformes	Teleostei
Bothus	Bothidae	Pleuronectiformes	Teleostei
Pseudupeneus	Mullidae	Mulliformes	Teleostei
Anarchias	Muraenidae	Anguilliformes	Teleostei
Pamphorichthys	Poeciliidae	Cyprinodontiformes	Teleostei
Anatolichthys	Aphaniidae	Cyprinodontiformes	Teleostei
Lachneratus	Apogonidae	Kurtiformes	Teleostei
Monacanthus	Monacanthidae	Tetraodontiformes	Teleostei
Dactylopterus	Dactylopteridae	Dactylopteriformes	Teleostei
Spirinchus	Osmeridae	Osmeriformes	Teleostei
Paradiplospinus	Gempylidae	Scombriformes	Teleostei
Polysticta	Anatidae	Anseriformes	Aves
Halimochirurgus	Triacanthodidae	Tetraodontiformes	Teleostei
Grammonus	Bythitidae	Ophidiiformes	Teleostei
Acantholiparis	Liparidae	Perciformes/Cottoidei	Teleostei
Speculanas	Anatidae	Anseriformes	Aves
Hemitilapia	Cichlidae	Cichliformes	Teleostei
Amissidens	Ariidae	Siluriformes	Teleostei
Aetomylaeus	Myliobatidae	Myliobatiformes	Elasmobranchii
Ditrema	Embiotocidae	Ovalentaria/misc	Teleostei
Neochen	Anatidae	Anseriformes	Aves
Taeniamia	Apogonidae	Kurtiformes	Teleostei
Radiicephalus	Radiicephalidae	Lampriformes	Teleostei
Halicmetus	Ogcocephalidae	Lophiiformes	Teleostei
Macolor	Lutjanidae	Eupercaria/misc	Teleostei
Pimelodella	Heptapteridae	Siluriformes	Teleostei
Flavocaranx	Carangidae	Carangiformes	Teleostei
Agonostomus	Mugilidae	Mugiliformes	Teleostei
Sorosichthys	Trachichthyidae	Trachichthyiformes	Teleostei
Mitotichthys	Syngnathidae	Syngnathiformes	Teleostei
Derepodichthys	Zoarcidae	Perciformes/Zoarcoidei	Teleostei
Nectamia	Apogonidae	Kurtiformes	Teleostei
Neolaeops	Bothidae	Pleuronectiformes	Teleostei
Platybelone	Belonidae	Beloniformes	Teleostei
Minous	Synanceiidae	Perciformes/Scorpaenoidei	Teleostei
Aphanotorulus	Loricariidae	Siluriformes	Teleostei
Arripis	Arripidae	Scombriformes	Teleostei
Histiogamphelus	Syngnathidae	Syngnathiformes	Teleostei
Gadopsis	Percichthyidae	Centrarchiformes	Teleostei
Rajella	Rajidae	Rajiformes	Elasmobranchii
Procetichthys	Cetomimidae	Beryciformes	Teleostei
Pervagor	Monacanthidae	Tetraodontiformes	Teleostei
Herichthys	Cichlidae	Cichliformes	Teleostei
Ablabys	Tetrarogidae	Perciformes/Scorpaenoidei	Teleostei
Yarica	Apogonidae	Kurtiformes	Teleostei
Dendrophysa	Sciaenidae	Eupercaria/misc	Teleostei
Rhinoraja	Arhynchobatidae	Rajiformes	Elasmobranchii
Caranx	Carangidae	Carangiformes	Teleostei
Guavina	Eleotridae	Gobiiformes	Teleostei
Stenotomus	Sparidae	Eupercaria/misc	Teleostei
Nealotus	Gempylidae	Scombriformes	Teleostei
Conocara	Alepocephalidae	Alepocephaliformes	Teleostei
Centrolabrus	Labridae	Eupercaria/misc	Teleostei
Oxyzygonectes	Anablepidae	Cyprinodontiformes	Teleostei
Chirocentrus	Chirocentridae	Clupeiformes	Teleostei
Acentrogobius	Gobiidae	Gobiiformes	Teleostei
Diplodus	Sparidae	Eupercaria/misc	Teleostei
Relictus	Leuciscidae	Cypriniformes	Teleostei
Onigocia	Platycephalidae	Perciformes/Scorpaenoidei	Teleostei
Papilloculiceps	Platycephalidae	Perciformes/Scorpaenoidei	Teleostei
Paraliparis	Liparidae	Perciformes/Cottoidei	Teleostei
Thalassobathia	Bythitidae	Ophidiiformes	Teleostei
Atractoscion	Sciaenidae	Eupercaria/misc	Teleostei
Rexea	Gempylidae	Scombriformes	Teleostei
Kumococius	Platycephalidae	Perciformes/Scorpaenoidei	Teleostei
Neoachiropsetta	Achiropsettidae	Pleuronectiformes	Teleostei
Apocryptes	Oxudercidae	Gobiiformes	Teleostei
Leptojulis	Labridae	Eupercaria/misc	Teleostei
Salangichthys	Salangidae	Osmeriformes	Teleostei
Ferdauia	Carangidae	Carangiformes	Teleostei
Robinsia	Chlopsidae	Anguilliformes	Teleostei
Mesogobius	Gobiidae	Gobiiformes	Teleostei
Rhizoprionodon	Carcharhinidae	Carcharhiniformes	Elasmobranchii
Chaenophryne	Oneirodidae	Lophiiformes	Teleostei
Insentiraja	Arhynchobatidae	Rajiformes	Elasmobranchii
Nudiantennarius	Antennariidae	Lophiiformes	Teleostei
Alburnoides	Leuciscidae	Cypriniformes	Teleostei
Lactophrys	Ostraciidae	Tetraodontiformes	Teleostei
Engraulis	Engraulidae	Clupeiformes	Teleostei
Nibea	Sciaenidae	Eupercaria/misc	Teleostei
Nebris	Sciaenidae	Eupercaria/misc	Teleostei
Pholidapus	Opisthocentridae	Perciformes/Zoarcoidei	Teleostei
Monopterus	Synbranchidae	Synbranchiformes	Teleostei
Parioglossus	Microdesmidae	Gobiiformes	Teleostei
Hypoplectrus	Serranidae	Perciformes/Serranoidei	Teleostei
Chirolophis	Stichaeidae	Perciformes/Zoarcoidei	Teleostei
Pherallodiscus	Gobiesocidae	Gobiesociformes	Teleostei
Crapatalus	Leptoscopidae	Acropomatiformes	Teleostei
Scopelarchus	Scopelarchidae	Aulopiformes	Teleostei
Leptomelanosoma	Polynemidae	Carangaria/misc	Teleostei
Lubricogobius	Gobiidae	Gobiiformes	Teleostei
Mastiglanis	Heptapteridae	Siluriformes	Teleostei
Ladigesocypris	Leuciscidae	Cypriniformes	Teleostei
Bidyanus	Terapontidae	Centrarchiformes	Teleostei
Bodianus	Labridae	Eupercaria/misc	Teleostei
Rheoheros	Cichlidae	Cichliformes	Teleostei
Rachovia	Rivulidae	Cyprinodontiformes	Teleostei
Stelgistrum	Cottidae	Perciformes/Cottoidei	Teleostei
Crossosalarias	Blenniidae	Blenniiformes	Teleostei
Euprotomicrus	Dalatiidae	Squaliformes	Elasmobranchii
Marmaronetta	Anatidae	Anseriformes	Aves
Stegastes	Pomacentridae	Ovalentaria/misc	Teleostei
Lycothrissa	Engraulidae	Clupeiformes	Teleostei
Stomias	Stomiidae	Stomiiformes	Teleostei
Dendrochirus	Scorpaenidae	Perciformes/Scorpaenoidei	Teleostei
Urocampus	Syngnathidae	Syngnathiformes	Teleostei
Urogymnus	Dasyatidae	Myliobatiformes	Elasmobranchii
Inimicus	Synanceiidae	Perciformes/Scorpaenoidei	Teleostei
Carcharodon	Lamnidae	Lamniformes	Elasmobranchii
Chelmon	Chaetodontidae	Acanthuriformes	Teleostei
Prionobutis	Butidae	Gobiiformes	Teleostei
Chroicocephalus	Laridae	Charadriiformes	Aves
Hadropareia	Zoarcidae	Perciformes/Zoarcoidei	Teleostei
Cancelloxus	Clinidae	Blenniiformes	Teleostei
Lamna	Lamnidae	Lamniformes	Elasmobranchii
Glyptoparus	Blenniidae	Blenniiformes	Teleostei
Sicyopterus	Gobiidae	Gobiiformes	Teleostei
Cirrhilabrus	Labridae	Eupercaria/misc	Teleostei
Nectoliparis	Liparidae	Perciformes/Cottoidei	Teleostei
Echiodon	Carapidae	Ophidiiformes	Teleostei
Theraps	Cichlidae	Cichliformes	Teleostei
Exerpes	Labrisomidae	Blenniiformes	Teleostei
Platyberyx	Caristiidae	Scombriformes	Teleostei
Fregata	Fregatidae	Pelecaniformes	Aves
Barryichthys	Gobiesocidae	Gobiesociformes	Teleostei
Clanga	Accipitridae	Falconiformes	Aves
Elseyornis	Charadriidae	Charadriiformes	Aves
Zalophus	Otariidae	Carnivora	Mammalia
Morus	Moraceae	Rosales	Magnoliopsida
Micrenophrys	Cottidae	Perciformes/Cottoidei	Teleostei
Halieutopsis	Ogcocephalidae	Lophiiformes	Teleostei
Styracura	Potamotrygonidae	Myliobatiformes	Elasmobranchii
Synechogobius	Gobiidae	Gobiiformes	Teleostei
Isorineloricaria	Loricariidae	Siluriformes	Teleostei
Samariscus	Samaridae	Pleuronectiformes	Teleostei
Pentaceros	Pentacerotidae	Acropomatiformes	Teleostei
Nicholsina	Scaridae	Eupercaria/misc	Teleostei
Haliastur	Accipitridae	Falconiformes	Aves
Delphinus	Delphinidae	Cetartiodactyla	Mammalia
Atherinella	Atherinopsidae	Atheriniformes	Teleostei
Aulohalaelurus	Atelomycteridae	Carcharhiniformes	Elasmobranchii
Melanorivulus	Rivulidae	Cyprinodontiformes	Teleostei
Kyphosus	Kyphosidae	Centrarchiformes	Teleostei
Blennius	Blenniidae	Blenniiformes	Teleostei
Lipariscus	Liparidae	Perciformes/Cottoidei	Teleostei
Ronquilus	Bathymasteridae	Perciformes/Zoarcoidei	Teleostei
Synaptura	Soleidae	Pleuronectiformes	Teleostei
Pseudamia	Apogonidae	Kurtiformes	Teleostei
Aphia	Gobiidae	Gobiiformes	Teleostei
Spizaetus	Accipitridae	Falconiformes	Aves
Cottoperca	Bovichtidae	Perciformes/Notothenioidei	Teleostei
Branchiostegus	Latilidae	Eupercaria/misc	Teleostei
Drepane	Drepaneidae	Acanthuriformes	Teleostei
Ernogrammus	Stichaeidae	Perciformes/Zoarcoidei	Teleostei
Hemanthias	Anthiadidae	Perciformes/Serranoidei	Teleostei
Neochanna	Galaxiidae	Galaxiiformes	Teleostei
Rhabdoblennius	Blenniidae	Blenniiformes	Teleostei
Taractes	Bramidae	Scombriformes	Teleostei
Ancistrus	Loricariidae	Siluriformes	Teleostei
Pseudolarimichthys	Sciaenidae	Eupercaria/misc	Teleostei
Pogonichthys	Leuciscidae	Cypriniformes	Teleostei
Leptaulopus	Aulopidae	Aulopiformes	Teleostei
Pelates	Terapontidae	Centrarchiformes	Teleostei
Achirus	Achiridae	Pleuronectiformes	Teleostei
Kurtus	Kurtidae	Kurtiformes	Teleostei
Proloricaria	Loricariidae	Siluriformes	Teleostei
Thalassornis	Anatidae	Anseriformes	Aves
Tenualosa	Dorosomatidae	Clupeiformes	Teleostei
Pseudalectrias	Stichaeidae	Perciformes/Zoarcoidei	Teleostei
Zu	Trachipteridae	Lampriformes	Teleostei
Cheilodactylus	Cheilodactylidae	Centrarchiformes	Teleostei
Nemadactylus	Latridae	Centrarchiformes	Teleostei
Gymnocaesio	Caesionidae	Eupercaria/misc	Teleostei
Microgobius	Gobiidae	Gobiiformes	Teleostei
Gobius	Gobiidae	Gobiiformes	Teleostei
Diceratias	Diceratiidae	Lophiiformes	Teleostei
Hemicaranx	Carangidae	Carangiformes	Teleostei
Gracilimugil	Mugilidae	Mugiliformes	Teleostei
Cryptocentroides	Gobiidae	Gobiiformes	Teleostei
Clepticus	Labridae	Eupercaria/misc	Teleostei
Plagiopsetta	Samaridae	Pleuronectiformes	Teleostei
Krusensterniella	Zoarcidae	Perciformes/Zoarcoidei	Teleostei
Equetus	Sciaenidae	Eupercaria/misc	Teleostei
Astronotus	Cichlidae	Cichliformes	Teleostei
Heterodontus	Heterodontidae	Heterodontiformes	Elasmobranchii
Merlangius	Gadidae	Gadiformes	Teleostei
Tachybaptus	Podicipedidae	Podicipediformes	Aves
Rhodichthys	Liparidae	Perciformes/Cottoidei	Teleostei
Amphilophus	Cichlidae	Cichliformes	Teleostei
Panamius	Cichlidae	Cichliformes	Teleostei
Rhinoliparis	Liparidae	Perciformes/Cottoidei	Teleostei
Lepadichthys	Gobiesocidae	Gobiesociformes	Teleostei
Aspiolucius	Leuciscidae	Cypriniformes	Teleostei
Megachasma	Megachasmidae	Lamniformes	Elasmobranchii
Cristiceps	Clinidae	Blenniiformes	Teleostei
Sphaeramia	Apogonidae	Kurtiformes	Teleostei
Herklotsichthys	Dorosomatidae	Clupeiformes	Teleostei
Dibranchus	Ogcocephalidae	Lophiiformes	Teleostei
Bathydraco	Bathydraconidae	Perciformes/Notothenioidei	Teleostei
Neobathyclupea	Bathyclupeidae	Acropomatiformes	Teleostei
Tewara	Creediidae	Acropomatiformes	Teleostei
Crocodilichthys	Tripterygiidae	Blenniiformes	Teleostei
Paracentropyge	Pomacanthidae	Acanthuriformes	Teleostei
Cystophora	Phocidae	Carnivora	Mammalia
Serranochromis	Cichlidae	Cichliformes	Teleostei
Sciaena	Sciaenidae	Eupercaria/misc	Teleostei
Parataeniophorus	Cetomimidae	Beryciformes	Teleostei
Xanthichthys	Balistidae	Tetraodontiformes	Teleostei
Pentapodus	Nemipteridae	Eupercaria/misc	Teleostei
Leptatherina	Atherinidae	Atheriniformes	Teleostei
Luzonichthys	Anthiadidae	Perciformes/Serranoidei	Teleostei
Brachyglanis	Heptapteridae	Siluriformes	Teleostei
Einara	Alepocephalidae	Alepocephaliformes	Teleostei
Kathetostoma	Uranoscopidae	Perciformes/Uranoscopoidei	Teleostei
Diplocrepis	Gobiesocidae	Gobiesociformes	Teleostei
Hoplolatilus	Malacanthidae	Eupercaria/misc	Teleostei
Vomeridens	Bathydraconidae	Perciformes/Notothenioidei	Teleostei
Sciaenops	Sciaenidae	Eupercaria/misc	Teleostei
Nesiarchus	Gempylidae	Scombriformes	Teleostei
Caspiomyzon	Petromyzontidae	Petromyzontiformes	Petromyzonti
Heteronetta	Anatidae	Anseriformes	Aves
Phenacobius	Leuciscidae	Cypriniformes	Teleostei
Encrasicholina	Engraulidae	Clupeiformes	Teleostei
Xenobalistes	Balistidae	Tetraodontiformes	Teleostei
Pherallodus	Gobiesocidae	Gobiesociformes	Teleostei
Tetraroge	Tetrarogidae	Perciformes/Scorpaenoidei	Teleostei
Cologrammus	Clinidae	Blenniiformes	Teleostei
Aethia	Alcidae	Charadriiformes	Aves
Tripterodon	Ephippidae	Acanthuriformes	Teleostei
Notoraja	Arhynchobatidae	Rajiformes	Elasmobranchii
Glyptophidium	Ophidiidae	Ophidiiformes	Teleostei
Brachaluteres	Monacanthidae	Tetraodontiformes	Teleostei
Ostracoberyx	Ostracoberycidae	Acropomatiformes	Teleostei
Gymnapistes	Tetrarogidae	Perciformes/Scorpaenoidei	Teleostei
Edentoliparis	Liparidae	Perciformes/Cottoidei	Teleostei
Margrethia	Gonostomatidae	Stomiiformes	Teleostei
Pseudogobiopsis	Gobiidae	Gobiiformes	Teleostei
Sirembo	Ophidiidae	Ophidiiformes	Teleostei
Niphon	Niphonidae	Perciformes/Percoidei	Teleostei
Craterognathus	Carangidae	Carangiformes	Teleostei
Thryssa	Engraulidae	Clupeiformes	Teleostei
Radulinopsis	Cottidae	Perciformes/Cottoidei	Teleostei
Paraloricaria	Loricariidae	Siluriformes	Teleostei
Genidens	Ariidae	Siluriformes	Teleostei
Poeciliopsis	Poeciliidae	Cyprinodontiformes	Teleostei
Gymnelus	Zoarcidae	Perciformes/Zoarcoidei	Teleostei
Kasatkia	Opisthocentridae	Perciformes/Zoarcoidei	Teleostei
Bathyuroconger	Congridae	Anguilliformes	Teleostei
Stercorarius	Stercorariidae	Charadriiformes	Aves
Penetopteryx	Syngnathidae	Syngnathiformes	Teleostei
Trimma	Gobiidae	Gobiiformes	Teleostei
Symphysodon	Cichlidae	Cichliformes	Teleostei
Crossorhombus	Bothidae	Pleuronectiformes	Teleostei
Megaptera	Balaenopteridae	Cetartiodactyla	Mammalia
Eumetopias	Otariidae	Carnivora	Mammalia
Psednos	Liparidae	Perciformes/Cottoidei	Teleostei
Erimystax	Leuciscidae	Cypriniformes	Teleostei
Hypoptychus	Hypoptychidae	Perciformes/Gasterosteoidei	Teleostei
Anableps	Anablepidae	Cyprinodontiformes	Teleostei
Amanses	Monacanthidae	Tetraodontiformes	Teleostei
Electrona	Myctophidae	Myctophiformes	Teleostei
Mangarinus	Gobiidae	Gobiiformes	Teleostei
Calamus	Sparidae	Eupercaria/misc	Teleostei
Japonoconger	Congridae	Anguilliformes	Teleostei
Ammodytes	Ammodytidae	Perciformes/Uranoscopoidei	Teleostei
Priapella	Poeciliidae	Cyprinodontiformes	Teleostei
Regalecus	Regalecidae	Lampriformes	Teleostei
Diproctacanthus	Labridae	Eupercaria/misc	Teleostei
Isopsetta	Pleuronectidae	Pleuronectiformes	Teleostei
Andriashevia	Zoarcidae	Perciformes/Zoarcoidei	Teleostei
Limbochromis	Cichlidae	Cichliformes	Teleostei
Schindleria	Schindleriidae	Gobiiformes	Teleostei
Trygonorrhina	Trygonorrhinidae	Rhinopristiformes	Elasmobranchii
Ichthyococcus	Phosichthyidae	Stomiiformes	Teleostei
Platanichthys	Dorosomatidae	Clupeiformes	Teleostei
Salanx	Salangidae	Osmeriformes	Teleostei
Acantholabrus	Labridae	Eupercaria/misc	Teleostei
Phanerodon	Embiotocidae	Ovalentaria/misc	Teleostei
Poliocephalus	Podicipedidae	Podicipediformes	Aves
Amarsipus	Amarsipidae	Scombriformes	Teleostei
Opisthoproctus	Opisthoproctidae	Argentiniformes	Teleostei
Notemigonus	Leuciscidae	Cypriniformes	Teleostei
Thunnus	Scombridae	Scombriformes	Teleostei
Karalla	Leiognathidae	Acanthuriformes	Teleostei
Stipecampus	Syngnathidae	Syngnathiformes	Teleostei
Istigobius	Gobiidae	Gobiiformes	Teleostei
Austrofundulus	Rivulidae	Cyprinodontiformes	Teleostei
Pogonias	Sciaenidae	Eupercaria/misc	Teleostei
Dormitator	Eleotridae	Gobiiformes	Teleostei
Teramulus	Atherinidae	Atheriniformes	Teleostei
Cosmocampus	Syngnathidae	Syngnathiformes	Teleostei
Ichthyomyzon	Petromyzontidae	Petromyzontiformes	Petromyzonti
Ctenosciaena	Sciaenidae	Eupercaria/misc	Teleostei
Sufflamen	Balistidae	Tetraodontiformes	Teleostei
Plesiotrygon	Potamotrygonidae	Myliobatiformes	Elasmobranchii
Syrigma	Ardeidae	Ciconiiformes	Aves
Porochilus	Plotosidae	Siluriformes	Teleostei
Pomatoschistus	Gobiidae	Gobiiformes	Teleostei
Loxodon	Carcharhinidae	Carcharhiniformes	Elasmobranchii
Polymetme	Phosichthyidae	Stomiiformes	Teleostei
Auxis	Scombridae	Scombriformes	Teleostei
Halieutichthys	Ogcocephalidae	Lophiiformes	Teleostei
Asterropteryx	Gobiidae	Gobiiformes	Teleostei
Marcelogobius	Gobiidae	Gobiiformes	Teleostei
Potamorrhaphis	Belonidae	Beloniformes	Teleostei
Malacosteus	Stomiidae	Stomiiformes	Teleostei
Anotopterus	Anotopteridae	Aulopiformes	Teleostei
Chaetodermis	Monacanthidae	Tetraodontiformes	Teleostei
Tonlesapia	Callionymidae	Callionymiformes	Teleostei
Gnathanacanthus	Gnathanacanthidae	Perciformes/Scorpaenoidei	Teleostei
Bothragonus	Agonidae	Perciformes/Cottoidei	Teleostei
Sigmops	Gonostomatidae	Stomiiformes	Teleostei
Pseudamiops	Apogonidae	Kurtiformes	Teleostei
Aeoliscus	Centriscidae	Syngnathiformes	Teleostei
Jurengraulis	Engraulidae	Clupeiformes	Teleostei
Eutaeniichthys	Gobiidae	Gobiiformes	Teleostei
Trachipterus	Trachipteridae	Lampriformes	Teleostei
Aploactisoma	Aploactinidae	Perciformes/Scorpaenoidei	Teleostei
Trygonoptera	Urolophidae	Myliobatiformes	Elasmobranchii
Galaxias	Galaxiidae	Galaxiiformes	Teleostei
Sinobatis	Anacanthobatidae	Rajiformes	Elasmobranchii
Amblygobius	Gobiidae	Gobiiformes	Teleostei
Wajpamheros	Cichlidae	Cichliformes	Teleostei
Hypsophrys	Cichlidae	Cichliformes	Teleostei
Chionobathyscus	Channichthyidae	Perciformes/Notothenioidei	Teleostei
Ninnigobius	Gobiidae	Gobiiformes	Teleostei
Cryptoheros	Cichlidae	Cichliformes	Teleostei
Sarcogyps	Accipitridae	Falconiformes	Aves
Netuma	Ariidae	Siluriformes	Teleostei
Leptolebias	Rivulidae	Cyprinodontiformes	Teleostei
Abantennarius	Antennariidae	Lophiiformes	Teleostei
Apterygocampus	Syngnathidae	Syngnathiformes	Teleostei
Congiopodus	Congiopodidae	Perciformes/Scorpaenoidei	Teleostei
Bythites	Bythitidae	Ophidiiformes	Teleostei
Antigonia	Antigoniidae	Acanthuriformes	Teleostei
Labroides	Labridae	Eupercaria/misc	Teleostei
Naso	Acanthuridae	Acanthuriformes	Teleostei
Sargocentron	Holocentridae	Holocentriformes	Teleostei
Oxyconger	Muraenesocidae	Anguilliformes	Teleostei
Enneacampus	Syngnathidae	Syngnathiformes	Teleostei
Trypauchenopsis	Gobiidae	Gobiiformes	Teleostei
Platalea	Threskiornithidae	Ciconiiformes	Aves
Aetapcus	Pataecidae	Perciformes/Scorpaenoidei	Teleostei
Neoepinnula	Gempylidae	Scombriformes	Teleostei
Polysteganus	Sparidae	Eupercaria/misc	Teleostei
Bathyanthias	Liopropomatidae	Perciformes/Serranoidei	Teleostei
Triathalassothia	Batrachoididae	Batrachoidiformes	Teleostei
Lycengraulis	Engraulidae	Clupeiformes	Teleostei
Negaprion	Carcharhinidae	Carcharhiniformes	Elasmobranchii
Clinus	Clinidae	Blenniiformes	Teleostei
Chascanopsetta	Bothidae	Pleuronectiformes	Teleostei
Schultzea	Serranidae	Perciformes/Serranoidei	Teleostei
Chanos	Chanidae	Gonorynchiformes	Teleostei
Peristrominous	Aploactinidae	Perciformes/Scorpaenoidei	Teleostei
Eudyptes	Spheniscidae	Sphenisciformes	Aves
Stephanoberyx	Stephanoberycidae	Beryciformes	Teleostei
Boreogadus	Gadidae	Gadiformes	Teleostei
Boops	Sparidae	Eupercaria/misc	Teleostei
Evoxymetopon	Trichiuridae	Scombriformes	Teleostei
Orthonopias	Cottidae	Perciformes/Cottoidei	Teleostei
Stemonidium	Serrivomeridae	Anguilliformes	Teleostei
Acarichthys	Cichlidae	Cichliformes	Teleostei
Pinguipes	Pinguipedidae	Perciformes/Uranoscopoidei	Teleostei
Rhinoptera	Rhinopteridae	Myliobatiformes	Elasmobranchii
Squatina	Squatinidae	Squatiniformes	Elasmobranchii
Anyperodon	Epinephelidae	Perciformes/Serranoidei	Teleostei
Argyropelecus	Sternoptychidae	Stomiiformes	Teleostei
Chelidonichthys	Triglidae	Perciformes/Scorpaenoidei	Teleostei
Hippoglossina	Paralichthyidae	Pleuronectiformes	Teleostei
Andamia	Blenniidae	Blenniiformes	Teleostei
Trachonurus	Macrouridae	Gadiformes	Teleostei
Leucosoma	Salangidae	Osmeriformes	Teleostei
Nannatherina	Percichthyidae	Centrarchiformes	Teleostei
Enchelynassa	Muraenidae	Anguilliformes	Teleostei
Gymnodraco	Bathydraconidae	Perciformes/Notothenioidei	Teleostei
Palutrus	Gobiidae	Gobiiformes	Teleostei
Actitis	Scolopacidae	Charadriiformes	Aves
Dalatias	Dalatiidae	Squaliformes	Elasmobranchii
Dichistius	Dichistiidae	Centrarchiformes	Teleostei
Ambophthalmos	Psychrolutidae	Perciformes/Cottoidei	Teleostei
Diretmichthys	Diretmidae	Trachichthyiformes	Teleostei
Pachychilon	Leuciscidae	Cypriniformes	Teleostei
Hemiodontichthys	Loricariidae	Siluriformes	Teleostei
Neomerinthe	Scorpaenidae	Perciformes/Scorpaenoidei	Teleostei
Lichia	Carangidae	Carangiformes	Teleostei
Gibberichthys	Gibberichthyidae	Beryciformes	Teleostei
Macrospinosa	Sciaenidae	Eupercaria/misc	Teleostei
Thysanophrys	Platycephalidae	Perciformes/Scorpaenoidei	Teleostei
Rhinolekos	Loricariidae	Siluriformes	Teleostei
Atherinops	Atherinopsidae	Atheriniformes	Teleostei
Leiognathus	Leiognathidae	Acanthuriformes	Teleostei
Nyctanassa	Ardeidae	Ciconiiformes	Aves
Zearaja	Rajidae	Rajiformes	Elasmobranchii
Doryrhamphus	Syngnathidae	Syngnathiformes	Teleostei
Leuciscus	Leuciscidae	Cypriniformes	Teleostei
Rhamphocottus	Rhamphocottidae	Perciformes/Cottoidei	Teleostei
Achondrostoma	Leuciscidae	Cypriniformes	Teleostei
Ctenogobius	Gobiidae	Gobiiformes	Teleostei
Neophoca	Otariidae	Carnivora	Mammalia
Xema	Laridae	Charadriiformes	Aves
Zaphotias	Gonostomatidae	Stomiiformes	Teleostei
Pavoraja	Arhynchobatidae	Rajiformes	Elasmobranchii
Cynoglossus	Cynoglossidae	Pleuronectiformes	Teleostei
Farlowella	Loricariidae	Siluriformes	Teleostei
Neoglyphidodon	Pomacentridae	Ovalentaria/misc	Teleostei
Daector	Batrachoididae	Batrachoidiformes	Teleostei
Crystallodytes	Creediidae	Acropomatiformes	Teleostei
Hypoclinemus	Achiridae	Pleuronectiformes	Teleostei
Brachypleura	Citharidae	Pleuronectiformes	Teleostei
Limia	Poeciliidae	Cyprinodontiformes	Teleostei
Zesticelus	Cottidae	Perciformes/Cottoidei	Teleostei
Bascanichthys	Ophichthidae	Anguilliformes	Teleostei
Telestes	Leuciscidae	Cypriniformes	Teleostei
Trematochromis	Cichlidae	Cichliformes	Teleostei
Psilogobius	Gobiidae	Gobiiformes	Teleostei
Protomyctophum	Myctophidae	Myctophiformes	Teleostei
Istiompax	Istiophoridae	Carangiformes	Teleostei
Sprattus	Clupeidae	Clupeiformes	Teleostei
Moema	Rivulidae	Cyprinodontiformes	Teleostei
Atherinason	Atherinidae	Atheriniformes	Teleostei
Gnathanodon	Carangidae	Carangiformes	Teleostei
Iranocichla	Cichlidae	Cichliformes	Teleostei
Neoscorpis	Kyphosidae	Centrarchiformes	Teleostei
Lepidozygus	Pomacentridae	Ovalentaria/misc	Teleostei
Mesoheros	Cichlidae	Cichliformes	Teleostei
Xyelacyba	Ophidiidae	Ophidiiformes	Teleostei
Papuligobius	Gobiidae	Gobiiformes	Teleostei
Saurenchelys	Nettastomatidae	Anguilliformes	Teleostei
Feia	Gobiidae	Gobiiformes	Teleostei
Bassogigas	Ophidiidae	Ophidiiformes	Teleostei
Xenophallus	Poeciliidae	Cyprinodontiformes	Teleostei
Recurvirostra	Recurvirostridae	Charadriiformes	Aves
Clupeonella	Ehiravidae	Clupeiformes	Teleostei
Plectrypops	Holocentridae	Holocentriformes	Teleostei
Benthodesmus	Trichiuridae	Scombriformes	Teleostei
Procottus	Cottidae	Perciformes/Cottoidei	Teleostei
Paracaristius	Caristiidae	Scombriformes	Teleostei
Eupetrichthys	Labridae	Eupercaria/misc	Teleostei
Cleidopus	Monocentridae	Trachichthyiformes	Teleostei
Diplectrum	Serranidae	Perciformes/Serranoidei	Teleostei
Chromogobius	Gobiidae	Gobiiformes	Teleostei
Evorthodus	Gobiidae	Gobiiformes	Teleostei
Nelusetta	Monacanthidae	Tetraodontiformes	Teleostei
Deveximentum	Leiognathidae	Acanthuriformes	Teleostei
Glyptauchen	Tetrarogidae	Perciformes/Scorpaenoidei	Teleostei
Notothenia	Nototheniidae	Perciformes/Notothenioidei	Teleostei
Pseudanthias	Anthiadidae	Perciformes/Serranoidei	Teleostei
Bathyprion	Alepocephalidae	Alepocephaliformes	Teleostei
Leptocottus	Cottidae	Perciformes/Cottoidei	Teleostei
Diplogrammus	Callionymidae	Callionymiformes	Teleostei
Pseudopoecilia	Poeciliidae	Cyprinodontiformes	Teleostei
Liocranium	Tetrarogidae	Perciformes/Scorpaenoidei	Teleostei
Paralepis	Paralepididae	Aulopiformes	Teleostei
Opistognathus	Opistognathidae	Ovalentaria/misc	Teleostei
Amphichaetodon	Chaetodontidae	Acanthuriformes	Teleostei
Anisotremus	Haemulidae	Eupercaria/misc	Teleostei
Odaxothrissa	Dorosomatidae	Clupeiformes	Teleostei
Plectroglyphidodon	Pomacentridae	Ovalentaria/misc	Teleostei
Neosalanx	Salangidae	Osmeriformes	Teleostei
Prosobonia	Scolopacidae	Charadriiformes	Aves
Periophthalmus	Oxudercidae	Gobiiformes	Teleostei
Bythaelurus	Pentanchidae	Carcharhiniformes	Elasmobranchii
Aidablennius	Blenniidae	Blenniiformes	Teleostei
Tydemania	Triacanthodidae	Tetraodontiformes	Teleostei
Liza	Mugilidae	Mugiliformes	Teleostei
Oxymonacanthus	Monacanthidae	Tetraodontiformes	Teleostei
Fistularia	Fistulariidae	Syngnathiformes	Teleostei
Dentex	Sparidae	Eupercaria/misc	Teleostei
Heteromycteris	Soleidae	Pleuronectiformes	Teleostei
Ixobrychus	Ardeidae	Ciconiiformes	Aves
Argyrosomus	Sciaenidae	Eupercaria/misc	Teleostei
Ptychochromis	Cichlidae	Cichliformes	Teleostei
Pherallodichthys	Gobiesocidae	Gobiesociformes	Teleostei
Upeneus	Mullidae	Mulliformes	Teleostei
Ariopsis	Ariidae	Siluriformes	Teleostei
Holapogon	Apogonidae	Kurtiformes	Teleostei
Phyllichthys	Soleidae	Pleuronectiformes	Teleostei
Centrolophus	Centrolophidae	Scombriformes	Teleostei
Mesovagus	Macrouridae	Gadiformes	Teleostei
Neocyttus	Oreosomatidae	Zeiformes	Teleostei
Chlidichthys	Pseudochromidae	Ovalentaria/misc	Teleostei
Cetopsorhamdia	Heptapteridae	Siluriformes	Teleostei
Delturus	Loricariidae	Siluriformes	Teleostei
Neoplecostomus	Loricariidae	Siluriformes	Teleostei
Hemitremia	Leuciscidae	Cypriniformes	Teleostei
Chitonotus	Cottidae	Perciformes/Cottoidei	Teleostei
Centropyge	Pomacanthidae	Acanthuriformes	Teleostei
Sarritor	Agonidae	Perciformes/Cottoidei	Teleostei
Taractichthys	Bramidae	Scombriformes	Teleostei
Isistius	Dalatiidae	Squaliformes	Elasmobranchii
Synagrops	Synagropidae	Acropomatiformes	Teleostei
Brachyopsis	Agonidae	Perciformes/Cottoidei	Teleostei
Oregonichthys	Leuciscidae	Cypriniformes	Teleostei
Prionace	Carcharhinidae	Carcharhiniformes	Elasmobranchii
Achoerodus	Labridae	Eupercaria/misc	Teleostei
Gomphosus	Labridae	Eupercaria/misc	Teleostei
Tyrannophryne	Oneirodidae	Lophiiformes	Teleostei
Scopelengys	Neoscopelidae	Myctophiformes	Teleostei
Fulmarus	Procellariidae	Procellariiformes	Aves
Erythrocles	Emmelichthyidae	Eupercaria/misc	Teleostei
Lucigadus	Macrouridae	Gadiformes	Teleostei
Corvula	Sciaenidae	Eupercaria/misc	Teleostei
Esmaeilius	Aphaniidae	Cyprinodontiformes	Teleostei
Ditropichthys	Cetomimidae	Beryciformes	Teleostei
Pronotogrammus	Anthiadidae	Perciformes/Serranoidei	Teleostei
Paraphanius	Aphaniidae	Cyprinodontiformes	Teleostei
Genyatremus	Haemulidae	Eupercaria/misc	Teleostei
Simpsonichthys	Rivulidae	Cyprinodontiformes	Teleostei
Kathala	Sciaenidae	Eupercaria/misc	Teleostei
Carinotetraodon	Tetraodontidae	Tetraodontiformes	Teleostei
Holacanthus	Pomacanthidae	Acanthuriformes	Teleostei
Xenolumpenus	Lumpenidae	Perciformes/Zoarcoidei	Teleostei
Sagmatias	Delphinidae	Cetartiodactyla	Mammalia
Arcos	Gobiesocidae	Gobiesociformes	Teleostei
Antennarius	Antennariidae	Lophiiformes	Teleostei
Uaru	Cichlidae	Cichliformes	Teleostei
Ophthalmolycus	Zoarcidae	Perciformes/Zoarcoidei	Teleostei
Imparfinis	Heptapteridae	Siluriformes	Teleostei
Johnius	Sciaenidae	Eupercaria/misc	Teleostei
Macrodontogobius	Gobiidae	Gobiiformes	Teleostei
Brama	Bramidae	Scombriformes	Teleostei
Gnathodentex	Lethrinidae	Eupercaria/misc	Teleostei
Aphareus	Lutjanidae	Eupercaria/misc	Teleostei
Plicomugil	Mugilidae	Mugiliformes	Teleostei
Anarhichas	Anarhichadidae	Perciformes/Zoarcoidei	Teleostei
Tetrapturus	Istiophoridae	Carangiformes	Teleostei
Dipturus	Rajidae	Rajiformes	Elasmobranchii
Kronichthys	Loricariidae	Siluriformes	Teleostei
Odontesthes	Atherinopsidae	Atheriniformes	Teleostei
Apogon	Apogonidae	Kurtiformes	Teleostei
Bathysauroides	Bathysauroididae	Aulopiformes	Teleostei
Kestratherina	Atherinidae	Atheriniformes	Teleostei
Parahollardia	Triacanthodidae	Tetraodontiformes	Teleostei
Bagre	Ariidae	Siluriformes	Teleostei
Eucyclogobius	Gobiidae	Gobiiformes	Teleostei
Lophiocharon	Histiophrynidae	Lophiiformes	Teleostei
Brephostoma	Epigonidae	Acropomatiformes	Teleostei
Botaurus	Ardeidae	Ciconiiformes	Aves
Herwigia	Alepocephalidae	Alepocephaliformes	Teleostei
Heterochromis	Cichlidae	Cichliformes	Teleostei
Gila	Leuciscidae	Cypriniformes	Teleostei
Favonigobius	Gobiidae	Gobiiformes	Teleostei
Cochleoceps	Gobiesocidae	Gobiesociformes	Teleostei
Scopelopsis	Myctophidae	Myctophiformes	Teleostei
Joturus	Mugilidae	Mugiliformes	Teleostei
Lopholatilus	Latilidae	Eupercaria/misc	Teleostei
Clinocottus	Cottidae	Perciformes/Cottoidei	Teleostei
Cetostoma	Cetomimidae	Beryciformes	Teleostei
Syngnathoides	Syngnathidae	Syngnathiformes	Teleostei
Lestradea	Cichlidae	Cichliformes	Teleostei
Gambusia	Poeciliidae	Cyprinodontiformes	Teleostei
Lamprogrammus	Ophidiidae	Ophidiiformes	Teleostei
Coscoroba	Anatidae	Anseriformes	Aves
Harriotta	Rhinochimaeridae	Chimaeriformes	Holocephali
Neomonachus	Phocidae	Carnivora	Mammalia
Careproctus	Liparidae	Perciformes/Cottoidei	Teleostei
Caffrogobius	Gobiidae	Gobiiformes	Teleostei
Auchenoceros	Moridae	Gadiformes	Teleostei
Mylochromis	Cichlidae	Cichliformes	Teleostei
Champsodon	Champsodontidae	Acropomatiformes	Teleostei
Oxymetopon	Microdesmidae	Gobiiformes	Teleostei
Cirrhitops	Cirrhitidae	Centrarchiformes	Teleostei
Pycnocraspedum	Ophidiidae	Ophidiiformes	Teleostei
Nomonyx	Anatidae	Anseriformes	Aves
Osopsaron	Hemerocoetidae	Acropomatiformes	Teleostei
Eusphyra	Sphyrnidae	Carcharhiniformes	Elasmobranchii
Gastrocymba	Gobiesocidae	Gobiesociformes	Teleostei
Cnidoglanis	Plotosidae	Siluriformes	Teleostei
Tampichthys	Leuciscidae	Cypriniformes	Teleostei
Glossolepis	Melanotaeniidae	Atheriniformes	Teleostei
Pungu	Cichlidae	Cichliformes	Teleostei
Apistus	Apistidae	Perciformes/Scorpaenoidei	Teleostei
Fowlerichthys	Antennariidae	Lophiiformes	Teleostei
Lumpenella	Lumpenidae	Perciformes/Zoarcoidei	Teleostei
Lithoxus	Loricariidae	Siluriformes	Teleostei
Argentina	Argentinidae	Argentiniformes	Teleostei
Solocisquama	Ogcocephalidae	Lophiiformes	Teleostei
Dules	Serranidae	Perciformes/Serranoidei	Teleostei
Pleurogrammus	Hexagrammidae	Perciformes/Cottoidei	Teleostei
Hongeo	Rajidae	Rajiformes	Elasmobranchii
Pugnaso	Syngnathidae	Syngnathiformes	Teleostei
Eubleekeria	Leiognathidae	Acanthuriformes	Teleostei
Cteniloricaria	Loricariidae	Siluriformes	Teleostei
Hemiemblemaria	Chaenopsidae	Blenniiformes	Teleostei
Solea	Soleidae	Pleuronectiformes	Teleostei
Gobiopsis	Gobiidae	Gobiiformes	Teleostei
Chirocentrodon	Pristigasteridae	Clupeiformes	Teleostei
Totoaba	Sciaenidae	Eupercaria/misc	Teleostei
Channichthys	Channichthyidae	Perciformes/Notothenioidei	Teleostei
Parophidion	Ophidiidae	Ophidiiformes	Teleostei
Cephalocassis	Ariidae	Siluriformes	Teleostei
Sicyopus	Gobiidae	Gobiiformes	Teleostei
Lobodon	Phocidae	Carnivora	Mammalia
Synodus	Synodontidae	Aulopiformes	Teleostei
Scartelaos	Oxudercidae	Gobiiformes	Teleostei
Paracentropogon	Tetrarogidae	Perciformes/Scorpaenoidei	Teleostei
Euristhmus	Plotosidae	Siluriformes	Teleostei
Wheelerigobius	Gobiidae	Gobiiformes	Teleostei
Hilsa	Dorosomatidae	Clupeiformes	Teleostei
Lycodes	Zoarcidae	Perciformes/Zoarcoidei	Teleostei
Isopisthus	Sciaenidae	Eupercaria/misc	Teleostei
Mobula	Mobulidae	Myliobatiformes	Elasmobranchii
Rhamdella	Heptapteridae	Siluriformes	Teleostei
Caulophryne	Caulophrynidae	Lophiiformes	Teleostei
Triodon	Triodontidae	Tetraodontiformes	Teleostei
Melanitta	Anatidae	Anseriformes	Aves
Meda	Leuciscidae	Cypriniformes	Teleostei
Mergus	Anatidae	Anseriformes	Aves
Euleptorhamphus	Hemiramphidae	Beloniformes	Teleostei
Liopsetta	Pleuronectidae	Pleuronectiformes	Teleostei
Aptenodytes	Spheniscidae	Sphenisciformes	Aves
Phtheirichthys	Echeneidae	Carangiformes	Teleostei
Anaecypris	Leuciscidae	Cypriniformes	Teleostei
Leptostomias	Stomiidae	Stomiiformes	Teleostei
Gillichthys	Gobiidae	Gobiiformes	Teleostei
Taunayia	Heptapteridae	Siluriformes	Teleostei
Grallenia	Gobiidae	Gobiiformes	Teleostei
Parapterois	Scorpaenidae	Perciformes/Scorpaenoidei	Teleostei
Tomicodon	Gobiesocidae	Gobiesociformes	Teleostei
Lutjanus	Lutjanidae	Eupercaria/misc	Teleostei
Abudefduf	Pomacentridae	Ovalentaria/misc	Teleostei
Mesonauta	Cichlidae	Cichliformes	Teleostei
Sphoeroides	Tetraodontidae	Tetraodontiformes	Teleostei
Chaenomugil	Mugilidae	Mugiliformes	Teleostei
Siphamia	Apogonidae	Kurtiformes	Teleostei
Radulinus	Cottidae	Perciformes/Cottoidei	Teleostei
Sphyraena	Sphyraenidae	Carangaria/misc	Teleostei
Congolapia	Cichlidae	Cichliformes	Teleostei
Haliaeetus	Accipitridae	Falconiformes	Aves
Tropheus	Cichlidae	Cichliformes	Teleostei
Pagophila	Laridae	Charadriiformes	Aves
Trachinus	Trachinidae	Perciformes/Percoidei	Teleostei
Pelagocephalus	Tetraodontidae	Tetraodontiformes	Teleostei
Meadia	Synaphobranchidae	Anguilliformes	Teleostei
Dellichthys	Gobiesocidae	Gobiesociformes	Teleostei
Hexagrammos	Hexagrammidae	Perciformes/Cottoidei	Teleostei
Crenicichla	Cichlidae	Cichliformes	Teleostei
Paratrypauchen	Gobiidae	Gobiiformes	Teleostei
Microlophichthys	Oneirodidae	Lophiiformes	Teleostei
Apterichtus	Ophichthidae	Anguilliformes	Teleostei
Pterogymnus	Sparidae	Eupercaria/misc	Teleostei
Sufflogobius	Gobiidae	Gobiiformes	Teleostei
Scophthalmus	Scophthalmidae	Pleuronectiformes	Teleostei
Synanceia	Synanceiidae	Perciformes/Scorpaenoidei	Teleostei
Chalinochromis	Cichlidae	Cichliformes	Teleostei
Lumpenopsis	Opisthocentridae	Perciformes/Zoarcoidei	Teleostei
Benthobatis	Narcinidae	Torpediniformes	Elasmobranchii
Heterandria	Poeciliidae	Cyprinodontiformes	Teleostei
Ichthyocampus	Syngnathidae	Syngnathiformes	Teleostei
Phalaropus	Phalaropodidae	Charadriiformes	Aves
Guianacara	Cichlidae	Cichliformes	Teleostei
Elacatinus	Gobiidae	Gobiiformes	Teleostei
Cyclopterus	Cyclopteridae	Perciformes/Cottoidei	Teleostei
Cryptopsilotris	Gobiidae	Gobiiformes	Teleostei
Monotaxis	Lethrinidae	Eupercaria/misc	Teleostei
Pomatomus	Pomatomidae	Scombriformes	Teleostei
Bilabria	Zoarcidae	Perciformes/Zoarcoidei	Teleostei
Tephrinectes	Paralichthyidae	Pleuronectiformes	Teleostei
Occella	Agonidae	Perciformes/Cottoidei	Teleostei
Inegocia	Platycephalidae	Perciformes/Scorpaenoidei	Teleostei
Tylosurus	Belonidae	Beloniformes	Teleostei
Dolicholagus	Bathylagidae	Argentiniformes	Teleostei
Chenonetta	Anatidae	Anseriformes	Aves
Contusus	Tetraodontidae	Tetraodontiformes	Teleostei
Lobianchia	Myctophidae	Myctophiformes	Teleostei
Sebastapistes	Scorpaenidae	Perciformes/Scorpaenoidei	Teleostei
Kryptolebias	Rivulidae	Cyprinodontiformes	Teleostei
Alticorpus	Cichlidae	Cichliformes	Teleostei
Oplopomus	Gobiidae	Gobiiformes	Teleostei
Epetriodus	Ophidiidae	Ophidiiformes	Teleostei
Choerodon	Labridae	Eupercaria/misc	Teleostei
Parascombrops	Synagropidae	Acropomatiformes	Teleostei
Ginglymostoma	Ginglymostomatidae	Orectolobiformes	Elasmobranchii
Mastigopterus	Ophidiidae	Ophidiiformes	Teleostei
Telmatochromis	Cichlidae	Cichliformes	Teleostei
Dayella	Ehiravidae	Clupeiformes	Teleostei
Bembrops	Bembropidae	Perciformes/Bembropoidei	Teleostei
Trachinocephalus	Synodontidae	Aulopiformes	Teleostei
Phoxinus	Leuciscidae	Cypriniformes	Teleostei
Escualosa	Dorosomatidae	Clupeiformes	Teleostei
Discotrema	Gobiesocidae	Gobiesociformes	Teleostei
Serraniculus	Serranidae	Perciformes/Serranoidei	Teleostei
Ocyurus	Lutjanidae	Eupercaria/misc	Teleostei
Ariomma	Ariommatidae	Scombriformes	Teleostei
Lavinia	Leuciscidae	Cypriniformes	Teleostei
Naucrates	Carangidae	Carangiformes	Teleostei
Petromyzon	Petromyzontidae	Petromyzontiformes	Petromyzonti
Circus	Accipitridae	Falconiformes	Aves
Tadorna	Anatidae	Anseriformes	Aves
Notholebias	Rivulidae	Cyprinodontiformes	Teleostei
Garrodia	Hydrobatidae	Procellariiformes	Aves
Astatotilapia	Cichlidae	Cichliformes	Teleostei
Lestrolepis	Lestidiidae	Aulopiformes	Teleostei
Anchovia	Engraulidae	Clupeiformes	Teleostei
Hypnos	Hypnidae	Torpediniformes	Elasmobranchii
Nemipterus	Nemipteridae	Eupercaria/misc	Teleostei
Ptychoramphus	Alcidae	Charadriiformes	Aves
Pterophyllum	Cichlidae	Cichliformes	Teleostei
Hetereleotris	Gobiidae	Gobiiformes	Teleostei
Hemiarius	Ariidae	Siluriformes	Teleostei
Hygophum	Myctophidae	Myctophiformes	Teleostei
Polyodon	Polyodontidae	Acipenseriformes	Chondrostei
Chaenodraco	Channichthyidae	Perciformes/Notothenioidei	Teleostei
Tathicarpus	Tathicarpidae	Lophiiformes	Teleostei
Ventrifossa	Macrouridae	Gadiformes	Teleostei
Daption	Procellariidae	Procellariiformes	Aves
Luxilus	Leuciscidae	Cypriniformes	Teleostei
Benthalbella	Scopelarchidae	Aulopiformes	Teleostei
Pterothrissus	Albulidae	Albuliformes	Teleostei
Valenciennellus	Sternoptychidae	Stomiiformes	Teleostei
Parachaetodon	Chaetodontidae	Acanthuriformes	Teleostei
Petroscirtes	Blenniidae	Blenniiformes	Teleostei
Makaira	Istiophoridae	Carangiformes	Teleostei
Diretmoides	Diretmidae	Trachichthyiformes	Teleostei
Mesembrinibis	Threskiornithidae	Ciconiiformes	Aves
Lateolabrax	Lateolabracidae	Acropomatiformes	Teleostei
Leptonotus	Syngnathidae	Syngnathiformes	Teleostei
Setarches	Setarchidae	Perciformes/Scorpaenoidei	Teleostei
Cymatognathus	Symphysanodontidae	Acropomatiformes	Teleostei
Marukawichthys	Rhamphocottidae	Perciformes/Cottoidei	Teleostei
Procellaria	Procellariidae	Procellariiformes	Aves
Stichaeopsis	Stichaeidae	Perciformes/Zoarcoidei	Teleostei
Hemiscyllium	Hemiscylliidae	Orectolobiformes	Elasmobranchii
Sillago	Sillaginidae	Eupercaria/misc	Teleostei
Macrocephenchelys	Congridae	Anguilliformes	Teleostei
Dactylopus	Callionymidae	Callionymiformes	Teleostei
Amblyglyphidodon	Pomacentridae	Ovalentaria/misc	Teleostei
Apionichthys	Achiridae	Pleuronectiformes	Teleostei
Urotrygon	Urotrygonidae	Myliobatiformes	Elasmobranchii
Tomeurus	Poeciliidae	Cyprinodontiformes	Teleostei
Vellitor	Cottidae	Perciformes/Cottoidei	Teleostei
Aulonocranus	Cichlidae	Cichliformes	Teleostei
Pterapogon	Apogonidae	Kurtiformes	Teleostei
Eutrigla	Triglidae	Perciformes/Scorpaenoidei	Teleostei
Arenigobius	Gobiidae	Gobiiformes	Teleostei
Micropogonias	Sciaenidae	Eupercaria/misc	Teleostei
Rhadinesthes	Stomiidae	Stomiiformes	Teleostei
Epinnula	Gempylidae	Scombriformes	Teleostei
Lepidamia	Apogonidae	Kurtiformes	Teleostei
Meiacanthus	Blenniidae	Blenniiformes	Teleostei
Arius	Ariidae	Siluriformes	Teleostei
Pterycombus	Bramidae	Scombriformes	Teleostei
Xenomystax	Congridae	Anguilliformes	Teleostei
Apolemichthys	Pomacanthidae	Acanthuriformes	Teleostei
Arhynchobatis	Arhynchobatidae	Rajiformes	Elasmobranchii
Odonus	Balistidae	Tetraodontiformes	Teleostei
Cheilochromis	Cichlidae	Cichliformes	Teleostei
Cirrhitus	Cirrhitidae	Centrarchiformes	Teleostei
Parona	Carangidae	Carangiformes	Teleostei
Japonolaeops	Bothidae	Pleuronectiformes	Teleostei
Echinophryne	Histiophrynidae	Lophiiformes	Teleostei
Diaphenchelys	Muraenidae	Anguilliformes	Teleostei
Nannoperca	Percichthyidae	Centrarchiformes	Teleostei
Malacosarcus	Stephanoberycidae	Beryciformes	Teleostei
Lythrurus	Leuciscidae	Cypriniformes	Teleostei
Arctoscopus	Trichodontidae	Perciformes/Uranoscopoidei	Teleostei
Osmerus	Osmeridae	Osmeriformes	Teleostei
Nezumia	Macrouridae	Gadiformes	Teleostei
Plectranthias	Anthiadidae	Perciformes/Serranoidei	Teleostei
Sillaginopodys	Sillaginidae	Eupercaria/misc	Teleostei
Helcogramma	Tripterygiidae	Blenniiformes	Teleostei
Aphrodroma	Procellariidae	Procellariiformes	Aves
Doryichthys	Syngnathidae	Syngnathiformes	Teleostei
Amazonetta	Anatidae	Anseriformes	Aves
Microcottus	Cottidae	Perciformes/Cottoidei	Teleostei
Neocyema	Neocyematidae	Saccopharyngiformes	Teleostei
Eckloniaichthys	Gobiesocidae	Gobiesociformes	Teleostei
Parapristipoma	Haemulidae	Eupercaria/misc	Teleostei
Pseudochondrostoma	Leuciscidae	Cypriniformes	Teleostei
Echiostoma	Stomiidae	Stomiiformes	Teleostei
Labidochromis	Cichlidae	Cichliformes	Teleostei
Paragobiodon	Gobiidae	Gobiiformes	Teleostei
Argyrozona	Sparidae	Eupercaria/misc	Teleostei
Pennahia	Sciaenidae	Eupercaria/misc	Teleostei
Milvus	Accipitridae	Falconiformes	Aves
Psammogobius	Gobiidae	Gobiiformes	Teleostei
Suttonia	Grammistidae	Perciformes/Serranoidei	Teleostei
Holcomycteronus	Ophidiidae	Ophidiiformes	Teleostei
Acanthaluteres	Monacanthidae	Tetraodontiformes	Teleostei
Plesioptopoma	Loricariidae	Siluriformes	Teleostei
Thalassoica	Procellariidae	Procellariiformes	Aves
Rissa	Laridae	Charadriiformes	Aves
Emmelichthys	Emmelichthyidae	Eupercaria/misc	Teleostei
Polymixia	Polymixiidae	Polymixiiformes	Teleostei
Cyprichromis	Cichlidae	Cichliformes	Teleostei
Rhomboplites	Lutjanidae	Eupercaria/misc	Teleostei
Diogenichthys	Myctophidae	Myctophiformes	Teleostei
Raja	Rajidae	Rajiformes	Elasmobranchii
Macrourus	Macrouridae	Gadiformes	Teleostei
Mirounga	Phocidae	Carnivora	Mammalia
Callorhinchus	Callorhinchidae	Chimaeriformes	Holocephali
Melamphaes	Melamphaidae	Beryciformes	Teleostei
Prosopium	Salmonidae	Salmoniformes	Teleostei
Okamejei	Rajidae	Rajiformes	Elasmobranchii
Amblyotrypauchen	Gobiidae	Gobiiformes	Teleostei
Tubbia	Centrolophidae	Scombriformes	Teleostei
Parascorpis	Parascorpididae	Centrarchiformes	Teleostei
Bostockia	Percichthyidae	Centrarchiformes	Teleostei
Hypoatherina	Atherinidae	Atheriniformes	Teleostei
Cirriemblemaria	Chaenopsidae	Blenniiformes	Teleostei
Ebinania	Psychrolutidae	Perciformes/Cottoidei	Teleostei
Spiniphryne	Oneirodidae	Lophiiformes	Teleostei
Nettapus	Anatidae	Anseriformes	Aves
Lampiella	Loricariidae	Siluriformes	Teleostei
Halobaena	Procellariidae	Procellariiformes	Aves
Arenaria	Caryophyllaceae	Caryophyllales	Magnoliopsida
Anarhynchus	Charadriidae	Charadriiformes	Aves
Gavialiceps	Muraenesocidae	Anguilliformes	Teleostei
Polyspina	Tetraodontidae	Tetraodontiformes	Teleostei
Aphyonus	Bythitidae	Ophidiiformes	Teleostei
Megacataetyx	Bythitidae	Ophidiiformes	Teleostei
Neoodax	Odacidae	Eupercaria/misc	Teleostei
Uranoscopus	Uranoscopidae	Perciformes/Uranoscopoidei	Teleostei
Schizolecis	Loricariidae	Siluriformes	Teleostei
Bathylagoides	Bathylagidae	Argentiniformes	Teleostei
Mirorictus	Platytroctidae	Alepocephaliformes	Teleostei
Tripterophycis	Moridae	Gadiformes	Teleostei
Trachinops	Plesiopidae	Ovalentaria/misc	Teleostei
Galeorhinus	Triakidae	Carcharhiniformes	Elasmobranchii
Suezichthys	Labridae	Eupercaria/misc	Teleostei
Lophotus	Lophotidae	Lampriformes	Teleostei
Dannevigia	Ophidiidae	Ophidiiformes	Teleostei
Krobia	Cichlidae	Cichliformes	Teleostei
Parabothus	Bothidae	Pleuronectiformes	Teleostei
Pavoclinus	Clinidae	Blenniiformes	Teleostei
Parachaeturichthys	Gobiidae	Gobiiformes	Teleostei
Astatoreochromis	Cichlidae	Cichliformes	Teleostei
Leiuranus	Ophichthidae	Anguilliformes	Teleostei
Coelotilapia	Cichlidae	Cichliformes	Teleostei
Potamosilurus	Ariidae	Siluriformes	Teleostei
Galeus	Pentanchidae	Carcharhiniformes	Elasmobranchii
Zoarchias	Neozoarcidae	Perciformes/Zoarcoidei	Teleostei
Bovitrigla	Triglidae	Perciformes/Scorpaenoidei	Teleostei
Smilosicyopus	Gobiidae	Gobiiformes	Teleostei
Neosiluroides	Plotosidae	Siluriformes	Teleostei
Aulotrachichthys	Trachichthyidae	Trachichthyiformes	Teleostei
Microstoma	Microstomatidae	Argentiniformes	Teleostei
Decodon	Labridae	Eupercaria/misc	Teleostei
Saurida	Synodontidae	Aulopiformes	Teleostei
Cyprinodon	Cyprinodontidae	Cyprinodontiformes	Teleostei
Callorhinus	Otariidae	Carnivora	Mammalia
Tanganicodus	Cichlidae	Cichliformes	Teleostei
Paragunnellichthys	Microdesmidae	Gobiiformes	Teleostei
Sturisoma	Loricariidae	Siluriformes	Teleostei
Cetomimus	Cetomimidae	Beryciformes	Teleostei
Batrachoides	Batrachoididae	Batrachoidiformes	Teleostei
Mancopsetta	Achiropsettidae	Pleuronectiformes	Teleostei
Aracana	Aracanidae	Tetraodontiformes	Teleostei
Boleophthalmus	Oxudercidae	Gobiiformes	Teleostei
Bathybates	Cichlidae	Cichliformes	Teleostei
Neosilurus	Plotosidae	Siluriformes	Teleostei
Collichthys	Sciaenidae	Eupercaria/misc	Teleostei
Bollmannia	Gobiidae	Gobiiformes	Teleostei
Pseudetroplus	Cichlidae	Cichliformes	Teleostei
Sacura	Anthiadidae	Perciformes/Serranoidei	Teleostei
Scomber	Scombridae	Scombriformes	Teleostei
Labracinus	Pseudochromidae	Ovalentaria/misc	Teleostei
Entomacrodus	Blenniidae	Blenniiformes	Teleostei
Lioscorpius	Setarchidae	Perciformes/Scorpaenoidei	Teleostei
Cerdale	Microdesmidae	Gobiiformes	Teleostei
Brotula	Ophidiidae	Ophidiiformes	Teleostei
Synclidopus	Soleidae	Pleuronectiformes	Teleostei
Mugilogobius	Gobiidae	Gobiiformes	Teleostei
Monodactylus	Monodactylidae	Eupercaria/misc	Teleostei
Paranisotremus	Haemulidae	Eupercaria/misc	Teleostei
Etropus	Cyclopsettidae	Pleuronectiformes	Teleostei
Squalogadus	Trachyrincidae	Gadiformes	Teleostei
Dactylophora	Latridae	Centrarchiformes	Teleostei
Acyrtus	Gobiesocidae	Gobiesociformes	Teleostei
Phoca	Phocidae	Carnivora	Mammalia
Pseudopercis	Pinguipedidae	Perciformes/Uranoscopoidei	Teleostei
Similiparma	Pomacentridae	Ovalentaria/misc	Teleostei
Verulux	Apogonidae	Kurtiformes	Teleostei
Idiolychnus	Myctophidae	Myctophiformes	Teleostei
Siokunichthys	Syngnathidae	Syngnathiformes	Teleostei
Pseudomonacanthus	Monacanthidae	Tetraodontiformes	Teleostei
Orestias	Cyprinodontidae	Cyprinodontiformes	Teleostei
Glyptocephalus	Pleuronectidae	Pleuronectiformes	Teleostei
Trichonotus	Trichonotidae	Gobiiformes	Teleostei
Dasyloricaria	Loricariidae	Siluriformes	Teleostei
Magnisudis	Paralepididae	Aulopiformes	Teleostei
Pseudonezumia	Macrouridae	Gadiformes	Teleostei
Melanolagus	Bathylagidae	Argentiniformes	Teleostei
Myzopsetta	Pleuronectidae	Pleuronectiformes	Teleostei
Mesoplodon	Ziphiidae	Cetartiodactyla	Mammalia
Panthalis	Acoetidae	Phyllodocida	Polychaeta
Plectrogenium	Plectrogeniidae	Perciformes/Scorpaenoidei	Teleostei
Oxyropsis	Loricariidae	Siluriformes	Teleostei
Propherallodus	Gobiesocidae	Gobiesociformes	Teleostei
Paranthias	Epinephelidae	Perciformes/Serranoidei	Teleostei
Chrysochir	Sciaenidae	Eupercaria/misc	Teleostei
Scymnodon	Somniosidae	Squaliformes	Elasmobranchii
Congriscus	Congridae	Anguilliformes	Teleostei
Cyttopsis	Parazenidae	Zeiformes	Teleostei
Manonichthys	Pseudochromidae	Ovalentaria/misc	Teleostei
Codoma	Leuciscidae	Cypriniformes	Teleostei
Hazeus	Gobiidae	Gobiiformes	Teleostei
Kamoharaia	Bothidae	Pleuronectiformes	Teleostei
Lophius	Lophiidae	Lophiiformes	Teleostei
Zaniolepis	Zaniolepididae	Perciformes/Cottoidei	Teleostei
Arcygobius	Gobiidae	Gobiiformes	Teleostei
Drombus	Gobiidae	Gobiiformes	Teleostei
Tosanoides	Anthiadidae	Perciformes/Serranoidei	Teleostei
Amblyrhynchotes	Tetraodontidae	Tetraodontiformes	Teleostei
Chuco	Cichlidae	Cichliformes	Teleostei
Colletteichthys	Batrachoididae	Batrachoidiformes	Teleostei
Amphichthys	Batrachoididae	Batrachoidiformes	Teleostei
Rhencus	Haemulidae	Eupercaria/misc	Teleostei
Rabaulichthys	Anthiadidae	Perciformes/Serranoidei	Teleostei
Aulopus	Aulopidae	Aulopiformes	Teleostei
Taeniopsetta	Bothidae	Pleuronectiformes	Teleostei
Vladichthys	Batrachoididae	Batrachoidiformes	Teleostei
Pelvicachromis	Cichlidae	Cichliformes	Teleostei
Coccorella	Evermannellidae	Aulopiformes	Teleostei
Engyprosopon	Bothidae	Pleuronectiformes	Teleostei
Scaphirhynchus	Acipenseridae	Acipenseriformes	Chondrostei
Facciolella	Nettastomatidae	Anguilliformes	Teleostei
Mylocheilus	Leuciscidae	Cypriniformes	Teleostei
Parargyrops	Sparidae	Eupercaria/misc	Teleostei
Limnocottus	Cottidae	Perciformes/Cottoidei	Teleostei
Belonesox	Poeciliidae	Cyprinodontiformes	Teleostei
Platytroctes	Platytroctidae	Alepocephaliformes	Teleostei
Heptapterus	Heptapteridae	Siluriformes	Teleostei
Malacoraja	Rajidae	Rajiformes	Elasmobranchii
Hemichromis	Cichlidae	Cichliformes	Teleostei
Lepophidium	Ophidiidae	Ophidiiformes	Teleostei
Uncisudis	Paralepididae	Aulopiformes	Teleostei
Ecsenius	Blenniidae	Blenniiformes	Teleostei
Gobioides	Gobiidae	Gobiiformes	Teleostei
Amblycirrhitus	Cirrhitidae	Centrarchiformes	Teleostei
Rhodostethia	Laridae	Charadriiformes	Aves
Dictyosoma	Stichaeidae	Perciformes/Zoarcoidei	Teleostei
Simochromis	Cichlidae	Cichliformes	Teleostei
Dermogenys	Zenarchopteridae	Beloniformes	Teleostei
Pseudalutarius	Monacanthidae	Tetraodontiformes	Teleostei
Pterochromis	Cichlidae	Cichliformes	Teleostei
Satanoperca	Cichlidae	Cichliformes	Teleostei
Antennatus	Antennariidae	Lophiiformes	Teleostei
Balaena	Balaenidae	Cetartiodactyla	Mammalia
Zenarchopterus	Zenarchopteridae	Beloniformes	Teleostei
Selenotoca	Scatophagidae	Acanthuriformes	Teleostei
Numenius	Scolopacidae	Charadriiformes	Aves
Hesperoleucus	Leuciscidae	Cypriniformes	Teleostei
Helotes	Terapontidae	Centrarchiformes	Teleostei
Aulonocara	Cichlidae	Cichliformes	Teleostei
Peter	Gobiidae	Gobiiformes	Teleostei
Neosebastes	Neosebastidae	Perciformes/Scorpaenoidei	Teleostei
Platygobiopsis	Gobiidae	Gobiiformes	Teleostei
Yongeichthys	Gobiidae	Gobiiformes	Teleostei
Palatogobius	Gobiidae	Gobiiformes	Teleostei
Crenicara	Cichlidae	Cichliformes	Teleostei
Oxyeleotris	Butidae	Gobiiformes	Teleostei
Biotoecus	Cichlidae	Cichliformes	Teleostei
Lota	Lotidae	Gadiformes	Teleostei
Selachophidium	Ophidiidae	Ophidiiformes	Teleostei
Grammatonotus	Callanthiidae	Eupercaria/misc	Teleostei
Apogonichthyoides	Apogonidae	Kurtiformes	Teleostei
Elanus	Accipitridae	Falconiformes	Aves
Bathytoshia	Dasyatidae	Myliobatiformes	Elasmobranchii
Papiliolebias	Rivulidae	Cyprinodontiformes	Teleostei
Alca	Alcidae	Charadriiformes	Aves
Hoplichthys	Hoplichthyidae	Perciformes/Scorpaenoidei	Teleostei
Hypogaleus	Triakidae	Carcharhiniformes	Elasmobranchii
Boehlkenchelys	Chlopsidae	Anguilliformes	Teleostei
Oceanodroma	Hydrobatidae	Procellariiformes	Aves
Labrichthys	Labridae	Eupercaria/misc	Teleostei
Etroplus	Cichlidae	Cichliformes	Teleostei
Etelis	Lutjanidae	Eupercaria/misc	Teleostei
Alionematichthys	Dinematichthyidae	Ophidiiformes	Teleostei
Istiblennius	Blenniidae	Blenniiformes	Teleostei
Chasmocranus	Heptapteridae	Siluriformes	Teleostei
Saccopharynx	Saccopharyngidae	Saccopharyngiformes	Teleostei
Hemigymnus	Labridae	Eupercaria/misc	Teleostei
Xyrichtys	Labridae	Eupercaria/misc	Teleostei
Myxine	Myxinidae	Myxiniformes	Myxini
Polynemus	Polynemidae	Carangaria/misc	Teleostei
Gorsachius	Ardeidae	Ciconiiformes	Aves
Boopsoidea	Sparidae	Eupercaria/misc	Teleostei
Cheimarrichthys	Cheimarrichthyidae	Perciformes/Uranoscopoidei	Teleostei
Opeatogenys	Gobiesocidae	Gobiesociformes	Teleostei
Pyramodon	Carapidae	Ophidiiformes	Teleostei
Coryphaena	Coryphaenidae	Carangiformes	Teleostei
Vinciguerria	Phosichthyidae	Stomiiformes	Teleostei
Thinornis	Charadriidae	Charadriiformes	Aves
Hippoglossoides	Pleuronectidae	Pleuronectiformes	Teleostei
Hemitrygon	Dasyatidae	Myliobatiformes	Elasmobranchii
Thoracochromis	Cichlidae	Cichliformes	Teleostei
Idiastion	Scorpaenidae	Perciformes/Scorpaenoidei	Teleostei
Lycodonus	Zoarcidae	Perciformes/Zoarcoidei	Teleostei
Phocarctos	Otariidae	Carnivora	Mammalia
Maccullochella	Percichthyidae	Centrarchiformes	Teleostei
Ocynectes	Cottidae	Perciformes/Cottoidei	Teleostei
Bostrychia	Threskiornithidae	Ciconiiformes	Aves
Thorichthys	Cichlidae	Cichliformes	Teleostei
Nansenia	Microstomatidae	Argentiniformes	Teleostei
Narcine	Narcinidae	Torpediniformes	Elasmobranchii
Ariosoma	Congridae	Anguilliformes	Teleostei
Stenogobius	Gobiidae	Gobiiformes	Teleostei
Dotsugobius	Gobiidae	Gobiiformes	Teleostei
Apogonichthys	Apogonidae	Kurtiformes	Teleostei
Chiasmodon	Chiasmodontidae	Scombriformes	Teleostei
Clupeichthys	Ehiravidae	Clupeiformes	Teleostei
Plicofollis	Ariidae	Siluriformes	Teleostei
Amblychaeturichthys	Gobiidae	Gobiiformes	Teleostei
Hypselecara	Cichlidae	Cichliformes	Teleostei
Spheniscus	Spheniscidae	Sphenisciformes	Aves
Diplotaxodon	Cichlidae	Cichliformes	Teleostei
Pseudoscopelus	Chiasmodontidae	Scombriformes	Teleostei
Aegypius	Accipitridae	Falconiformes	Aves
Pseudotolithus	Sciaenidae	Eupercaria/misc	Teleostei
Merluccius	Merlucciidae	Gadiformes	Teleostei
Pseudorhombus	Paralichthyidae	Pleuronectiformes	Teleostei
Heteroclinus	Clinidae	Blenniiformes	Teleostei
Allomycterus	Diodontidae	Tetraodontiformes	Teleostei
Kaupichthys	Chlopsidae	Anguilliformes	Teleostei
Oceanites	Hydrobatidae	Procellariiformes	Aves
Myliobatis	Myliobatidae	Myliobatiformes	Elasmobranchii
Paracetonurus	Macrouridae	Gadiformes	Teleostei
Diaphus	Myctophidae	Myctophiformes	Teleostei
Gramma	Grammatidae	Ovalentaria/misc	Teleostei
Lotilia	Gobiidae	Gobiiformes	Teleostei
Paraclinus	Labrisomidae	Blenniiformes	Teleostei
Neoheterandria	Poeciliidae	Cyprinodontiformes	Teleostei
Notoliparis	Liparidae	Perciformes/Cottoidei	Teleostei
Zanclistius	Pentacerotidae	Acropomatiformes	Teleostei
Cruriraja	Gurgesiellidae	Rajiformes	Elasmobranchii
Pristicon	Apogonidae	Kurtiformes	Teleostei
Monognathus	Monognathidae	Saccopharyngiformes	Teleostei
Rhombosolea	Rhombosoleidae	Pleuronectiformes	Teleostei
Gobulus	Gobiidae	Gobiiformes	Teleostei
Phalloptychus	Poeciliidae	Cyprinodontiformes	Teleostei
Citharichthys	Cyclopsettidae	Pleuronectiformes	Teleostei
Fossorochromis	Cichlidae	Cichliformes	Teleostei
Isbrueckerichthys	Loricariidae	Siluriformes	Teleostei
Ctenoscopelus	Myctophidae	Myctophiformes	Teleostei
Novaculoides	Labridae	Eupercaria/misc	Teleostei
Gerres	Gerreidae	Eupercaria/misc	Teleostei
Lagenodelphis	Delphinidae	Cetartiodactyla	Mammalia
Myroconger	Myrocongridae	Anguilliformes	Teleostei
Insidiator	Platycephalidae	Perciformes	Teleostei
Forsterygion	Tripterygiidae	Blenniiformes	Teleostei
Gnatholepis	Gobiidae	Gobiiformes	Teleostei
Perissodus	Cichlidae	Cichliformes	Teleostei
Labidesthes	Atherinopsidae	Atheriniformes	Teleostei
Ballerus	Leuciscidae	Cypriniformes	Teleostei
Cygnodraco	Bathydraconidae	Perciformes/Notothenioidei	Teleostei
Arctozenus	Paralepididae	Aulopiformes	Teleostei
Divandu	Cichlidae	Cichliformes	Teleostei
Coilia	Engraulidae	Clupeiformes	Teleostei
Egretta	Ardeidae	Ciconiiformes	Aves
Campellolebias	Rivulidae	Cyprinodontiformes	Teleostei
Limnothrissa	Dorosomatidae	Clupeiformes	Teleostei
Pliotrema	Pristiophoridae	Pristiophoriformes	Elasmobranchii
Dorosoma	Dorosomatidae	Clupeiformes	Teleostei
Verilus	Malakichthyidae	Acropomatiformes	Teleostei
Ptychocheilus	Leuciscidae	Cypriniformes	Teleostei
Pseudocalliurichthys	Callionymidae	Callionymiformes	Teleostei
Rhinogobius	Gobiidae	Gobiiformes	Teleostei
Paracheilinus	Labridae	Eupercaria/misc	Teleostei
Ijimaia	Ateleopodidae	Ateleopodiformes	Teleostei
Arotrolepis	Monacanthidae	Tetraodontiformes	Teleostei
Gonioplectrus	Epinephelidae	Perciformes/Serranoidei	Teleostei
Pomacanthus	Pomacanthidae	Acanthuriformes	Teleostei
Stomatepia	Cichlidae	Cichliformes	Teleostei
Leucicorus	Ophidiidae	Ophidiiformes	Teleostei
Placidochromis	Cichlidae	Cichliformes	Teleostei
Enneanectes	Tripterygiidae	Blenniiformes	Teleostei
Redigobius	Gobiidae	Gobiiformes	Teleostei
Cubanichthys	Cyprinodontidae	Cyprinodontiformes	Teleostei
Pachycara	Zoarcidae	Perciformes/Zoarcoidei	Teleostei
Pseudolabrus	Labridae	Eupercaria/misc	Teleostei
Lagocephalus	Tetraodontidae	Tetraodontiformes	Teleostei
Cyclopteropsis	Cyclopteridae	Perciformes/Cottoidei	Teleostei
Myopsaron	Creediidae	Acropomatiformes	Teleostei
Exoglossum	Leuciscidae	Cypriniformes	Teleostei
Podilymbus	Podicipedidae	Podicipediformes	Aves
Greenwoodochromis	Cichlidae	Cichliformes	Teleostei
Neozoarces	Neozoarcidae	Perciformes/Zoarcoidei	Teleostei
Xenotilapia	Cichlidae	Cichliformes	Teleostei
Muraenolepis	Muraenolepididae	Gadiformes	Teleostei
Idiolophorhynchus	Trachyrincidae	Gadiformes	Teleostei
Hoplerythrinus	Erythrinidae	Characiformes	Teleostei
Aulostomus	Aulostomidae	Syngnathiformes	Teleostei
Coryphaenoides	Macrouridae	Gadiformes	Teleostei
Hemitaurichthys	Chaetodontidae	Acanthuriformes	Teleostei
Amphiprion	Pomacentridae	Ovalentaria/misc	Teleostei
Pseudaspius	Leuciscidae	Cypriniformes	Teleostei
Parazanclistius	Pentacerotidae	Acropomatiformes	Teleostei
Nocomis	Leuciscidae	Cypriniformes	Teleostei
Cottus	Cottidae	Perciformes/Cottoidei	Teleostei
Navigobius	Microdesmidae	Gobiiformes	Teleostei
Cetoscarus	Scaridae	Eupercaria/misc	Teleostei
Xenobrama	Bramidae	Scombriformes	Teleostei
Platycephalus	Platycephalidae	Perciformes/Scorpaenoidei	Teleostei
Paedovaricus	Gobiidae	Gobiiformes	Teleostei
Mentodus	Platytroctidae	Alepocephaliformes	Teleostei
Rhynchocypris	Leuciscidae	Cypriniformes	Teleostei
Ichthyapus	Ophichthidae	Anguilliformes	Teleostei
Triso	Epinephelidae	Perciformes/Serranoidei	Teleostei
Osteoglossum	Osteoglossidae	Osteoglossiformes	Teleostei
Julidochromis	Cichlidae	Cichliformes	Teleostei
Acentronichthys	Heptapteridae	Siluriformes	Teleostei
Geophagus	Cichlidae	Cichliformes	Teleostei
Loraxichthys	Loricariidae	Siluriformes	Teleostei
Ephippion	Tetraodontidae	Tetraodontiformes	Teleostei
Schroederichthys	Atelomycteridae	Carcharhiniformes	Elasmobranchii
Symphorichthys	Lutjanidae	Eupercaria/misc	Teleostei
Lumpenus	Lumpenidae	Perciformes/Zoarcoidei	Teleostei
Dactyloptena	Dactylopteridae	Dactylopteriformes	Teleostei
Milyeringa	Milyeringidae	Gobiiformes	Teleostei
Sardinella	Dorosomatidae	Clupeiformes	Teleostei
Gastroscyphus	Gobiesocidae	Gobiesociformes	Teleostei
Gorogobius	Gobiidae	Gobiiformes	Teleostei
Iberochondrostoma	Leuciscidae	Cypriniformes	Teleostei
Evistias	Pentacerotidae	Acropomatiformes	Teleostei
Gnathochromis	Cichlidae	Cichliformes	Teleostei
Euclichthys	Euclichthyidae	Gadiformes	Teleostei
Lepidonectes	Tripterygiidae	Blenniiformes	Teleostei
Tilesina	Agonidae	Perciformes/Cottoidei	Teleostei
Eleutherochir	Callionymidae	Callionymiformes	Teleostei
Batrachocottus	Cottidae	Perciformes/Cottoidei	Teleostei
Hopliancistrus	Loricariidae	Siluriformes	Teleostei
Symbolophorus	Myctophidae	Myctophiformes	Teleostei
Aseraggodes	Soleidae	Pleuronectiformes	Teleostei
Lupinoblennius	Blenniidae	Blenniiformes	Teleostei
Phosichthys	Phosichthyidae	Stomiiformes	Teleostei
Xenoconger	Chlopsidae	Anguilliformes	Teleostei
Macroparalepis	Lestidiidae	Aulopiformes	Teleostei
Bunaka	Eleotridae	Gobiiformes	Teleostei
Petrus	Sparidae	Eupercaria/misc	Teleostei
Cottiusculus	Cottidae	Perciformes/Cottoidei	Teleostei
Simenchelys	Synaphobranchidae	Anguilliformes	Teleostei
Neophocaena	Phocoenidae	Cetartiodactyla	Mammalia
Parahucho	Salmonidae	Salmoniformes	Teleostei
Mimoblennius	Blenniidae	Blenniiformes	Teleostei
Chonerhinos	Tetraodontidae	Tetraodontiformes	Teleostei
Millerichthys	Rivulidae	Cyprinodontiformes	Teleostei
Awaous	Gobiidae	Gobiiformes	Teleostei
Spondyliosoma	Sparidae	Eupercaria/misc	Teleostei
Ophthalmotilapia	Cichlidae	Cichliformes	Teleostei
Gouania	Gobiesocidae	Gobiesociformes	Teleostei
Padogobius	Gobiidae	Gobiiformes	Teleostei
Luvarus	Luvaridae	Acanthuriformes	Teleostei
Pseudophycis	Moridae	Gadiformes	Teleostei
Nannothrissa	Dorosomatidae	Clupeiformes	Teleostei
Pseudocrenilabrus	Cichlidae	Cichliformes	Teleostei
Conger	Congridae	Anguilliformes	Teleostei
Pagellus	Sparidae	Eupercaria/misc	Teleostei
Eleotris	Eleotridae	Gobiiformes	Teleostei
Eutaeniophorus	Cetomimidae	Beryciformes	Teleostei
Acantholumpenus	Lumpenidae	Perciformes/Zoarcoidei	Teleostei
Pteroplatytrygon	Dasyatidae	Myliobatiformes	Elasmobranchii
Zanobatus	Zanobatidae	Myliobatiformes	Elasmobranchii
Ammolabrus	Labridae	Eupercaria/misc	Teleostei
Perulibatrachus	Batrachoididae	Batrachoidiformes	Teleostei
Hypsagonus	Agonidae	Perciformes/Cottoidei	Teleostei
Lepidiolamprologus	Cichlidae	Cichliformes	Teleostei
Haploblepharus	Pentanchidae	Carcharhiniformes	Elasmobranchii
Oxyporhamphus	Hemiramphidae	Beloniformes	Teleostei
Phyllorhinichthys	Oneirodidae	Lophiiformes	Teleostei
Ceratobregma	Tripterygiidae	Blenniiformes	Teleostei
Monolene	Bothidae	Pleuronectiformes	Teleostei
Acrocheilus	Leuciscidae	Cypriniformes	Teleostei
Cheiloprion	Pomacentridae	Ovalentaria/misc	Teleostei
Rhynchohyalus	Opisthoproctidae	Argentiniformes	Teleostei
Malapterus	Labridae	Eupercaria/misc	Teleostei
Haliichthys	Syngnathidae	Syngnathiformes	Teleostei
Clidoderma	Pleuronectidae	Pleuronectiformes	Teleostei
Gallinago	Scolopacidae	Charadriiformes	Aves
Morone	Moronidae	Eupercaria/misc	Teleostei
Neobythites	Ophidiidae	Ophidiiformes	Teleostei
Plectorhinchus	Haemulidae	Eupercaria/misc	Teleostei
Protogobiesox	Gobiesocidae	Gobiesociformes	Teleostei
Leptophilypnus	Eleotridae	Gobiiformes	Teleostei
Acroteriobatus	Rhinobatidae	Rhinopristiformes	Elasmobranchii
Ahliesaurus	Notosudidae	Aulopiformes	Teleostei
Teleogramma	Cichlidae	Cichliformes	Teleostei
Chilatherina	Melanotaeniidae	Atheriniformes	Teleostei
Geranoaetus	Accipitridae	Falconiformes	Aves
Eumegistus	Bramidae	Scombriformes	Teleostei
Neocentropogon	Tetrarogidae	Perciformes/Scorpaenoidei	Teleostei
Pseudoblennius	Cottidae	Perciformes/Cottoidei	Teleostei
Cirrisalarias	Blenniidae	Blenniiformes	Teleostei
Belonion	Belonidae	Beloniformes	Teleostei
Bathytroctes	Alepocephalidae	Alepocephaliformes	Teleostei
Cymolutes	Labridae	Eupercaria/misc	Teleostei
Neoarius	Ariidae	Siluriformes	Teleostei
Rachycentron	Rachycentridae	Carangiformes	Teleostei
Lactoria	Ostraciidae	Tetraodontiformes	Teleostei
Entelurus	Syngnathidae	Syngnathiformes	Teleostei
Rhycherus	Rhycheridae	Lophiiformes	Teleostei
Atherinopsis	Atherinopsidae	Atheriniformes	Teleostei
Corumbataia	Loricariidae	Siluriformes	Teleostei
Xenodermichthys	Alepocephalidae	Alepocephaliformes	Teleostei
Pseudaphya	Gobiidae	Gobiiformes	Teleostei
Sternula	Laridae	Charadriiformes	Aves
Blicca	Leuciscidae	Cypriniformes	Teleostei
Butorides	Ardeidae	Ciconiiformes	Aves
Idiotropiscis	Syngnathidae	Syngnathiformes	Teleostei
Rudarius	Monacanthidae	Tetraodontiformes	Teleostei
Notolepis	Paralepididae	Aulopiformes	Teleostei
Polyprion	Polyprionidae	Acropomatiformes	Teleostei
Caristius	Caristiidae	Scombriformes	Teleostei
